一	イ	イチ	イツ/イッ	イル	カズ	カツ	カヅ	テン	ハジメ	ヒ	ヒト	ヒトツ/ヒトッ	マコト
丁	チ	チョウ	チン	テイ	トウ	ヒノト	ヨロ
丂	コウ	サマタ
七	シ	シチ	シッ	ナ	ナナ	ナノ	ヒチ
丄	ア	ウエ	ウワ	カミ	ショウ/ジョウ	ノボ	ヨ
丅	オ	カ	クダ	ゲ	サ	シタ	シモ	モト
万	アラ	カズ	バン	マ	マン	ユル	ヨロズ
丈	ジョウ	タケ/ダケ	トモ	マスラ
三	カ	サ/ザ	サイ	サエ/ザエ	サブ/ザブ	サン/ザン	ソウ/ゾウ	ゾ	タダ	ミ	ミツ/ミッ	ミン	モ	ヤ
上	ア/アガ	アオイ	アガ/アガリ	アゲ	イ	ウエ	ウワ	エ	カ/ガ	カキ	カズ	カノ	カミ/ガミ	カミノ	カムラ	カン	コウ	シャン	ショウ/ジョウ	タテマツ	ノボ/ノボル	ノボリ	ホツ
下	オ/オリ/オロ	カ/ガ	クダ	ゲ	ゲノ	サ	サカ/サガ	シ	シタ/ジタ	シト	シモ/ジモ	モト
丌	キ	ゴ	ソ	ダイ
不	フ/ブ
与	アズ	アズカ	アタ	クミ/グミ	トモ	トモニ	ユ	ヨ
丐	カイ/ガイ	コ
丑	ウシ	チュウ	ヒロ
丒	ウシ	チュウ
且	アキ	カ	カツ	ショ	ショウ	ソ
丕	オオ	ヒ
世	セ/ゼ	セイ	ソウ	トシ	ユ	ユキ	ヨ
丗	サンジュウ	セ	セイ	ソウ	ヨ
丘	オカ	キュウ	タカシ
丙	ヒノエ	ヘイ
丞	ショウ/ジョウ	スク	スケ	ススム	タス
丟	サル	チュ	チュウ	ナゲウ
両	テル	フタツ	モロ	リョウ
丣	トリ	ユウ
两	テ	フタツ	リョウ
並	ナ	ナビ	ナミ	ナラ	ヘイ	ホウ
丨	コン	シ	シリゾ	ジョ	スス	ニョ	ボウ
个	カ	コ
丫	ア	アゲマキ	フタマタ	ヤ
中	アタ	アタル	ウチ	カナエ	ジュウ	チュウ	ナカ/ナガ
丮	キャク	ケキ	ト	モ
丯	カイ	サンラン
丰	シゲ	フ	フウ	ホウ	ミメヨ
丱	カン	ケン
串	カン	クシ/グシ	ケン	セン	ツラヌ
丵	クサノムラガリ	サク
丶	チュ	テン
丸	ガン	マ	マル	マルバエ	ワ	ワニ
丹	タ	タミ	タン/ダン	ニ	マコト
主	アルジ	オモ	カズ	シュ/ジュ	シュウ	ス/ズ	ヌシ	モン
丼	ショウ	セイ	タン	トン	ドン	ドンブリ
丿	エイ	ノ	ヘツ	ヨウ
乀	フツ	ブチ	マ
乁	イ	ナガ
乂	オサ	カ	カイ/ガイ	ゲ
乃	アイ	オ	オサム	スナワ	ダイ	ナイ	ナンジ	ノ	ノリ
乄	シ	シテ
久	キュ	キュウ/ギュウ	ク/グ	ナガ	ヒサ/ビサ	ヒサシ	ワ
乇	タク	チャク
之	アキ	イタル	クニ	コノ	コレ	シ/ジ	ツナ	ノ	ノブ	ヒサ	ヒデ	ユキ	ユク	ユミ
乍	サ	サク	タチマ	ナガ
乎	アア	オ	カ	カナ	コ	ヤ	ヨ	ヲ
乏	トボ	トモ	ボウ	マズ
乑	ギン	ゴン	シュウ	ナラビタツ
乕	コ	トラ
乖	カイ	ソム	モトル
乗	ショウ/ジョウ	ノ/ノセ/ノッ	ノリ
乘	ジョウ	ノ
乙	イツ/イッ	オツ/オッ	オト	キノト
乚	イン	オン	カカ	カク	ヨ	レ
乜	バ	メ	ヤブニラミ
九	イチジク	イチノク	キュウ/ギュウ	ク/グ	ココノ	コノ	ヒサシ
乞	キ	キケ	キツ	コ/ゴ	コチ	コツ/コッ	ゴイ
也	エ	カ	シ	ナリ	マタ	ヤ
乢	ガイ	タオ	タワ/ダワ
乣	キュウ
乨	シ	ハジ
乩	ウラナ	ケイ
乱	オサ	ミダ	ラ	ラン	ロン	ワタ
乳	ジ	チ	チチ	ニュウ
乴	セツ	ゼチ	ヒネ
乵	エン	スス
乹	イヌイ	カワ	カン	ケン	ヒ	ホ
乾	イヌイ	カラ	カワ/ガワ	カン	ケン	ヒ	ホ/ホシ/ボ	ホシ/ボシ
乿	オサ	ジ	チ
亀	カメ/ガメ	キ	キュウ	キン	ヒサ	ヒサシ
亂	オサ	ミダ	ラン	ロン	ワタ
亅	カギ	ケツ	ハネボウ
了	サトル	リョウ
予	アラカジ	カネ	シャ	ヨ
争	アラソ	イカ	ソウ
亊	コト	シ/ジ	ズ	ツカ
事	コト	ゴト	ジ	ズ	ツカ	ロ
二	オト	ジ	ツギ	ツグ	ニ	ニイ	ハ	フ	フタ/ブタ/プタ	フタタビ	フタツ	フダ	ワ
亍	タタズ	チョク
于	アア	ウ	オイテ	ク	ココニ	ニ	ヨリ	ヲ
云	イ	ウン	ココニ	ユ
互	カタミ	ゴ	タガ
五	イ	イツ	ゴ	サ	サツ	チ	フ	ミ	メ
井	イ	イノ	サイ	ショウ/ジョウ	セイ	ヒ/ビ
亖	シ	ヨ	ヨッ	ヨン
亗	サイ	セイ	トシ	トセ	ヨワ
亘	カン	コウ	セン	トウル	ノブ	ヒサシ	モト	ワタ/ワタリ	ワタル
亙	カン	コウ	ノブ	モト	ワタ
些	イササ	イササカ	サ	シャ	チ
亜	ア	ツ	ツギ	ツグ	ヤ
亝	ア	サイ	セイ	ソロ	ハヤ	ヒト
亞	ア	ツ
亟	キ	キョク	ケ	シバシバ	スミヤカ
亠	トウ	ナベブタ
亡	ナ	ホロ	ボウ	モウ
亢	コウ	タカブル
交	カ/ガ	カタ	カワ	コウ	コモゴモ	マ/マゼ	マジ/マジリ
亥	イ	カイ/ガイ	リ
亦	エキ	マタ	ヤク
亨	アキ	アキラ	キョウ	コウ	トウル	トオ	トオル	トオルフ	ナガ	ホウ	ミチ	ユキ	リョウ
享	アキラ	ウ	キョウ	コウ	ススム	タカ	タカシ	トオル	ミチ
京	キョウ/ギョウ	キン	ケイ	タカ	ミヤコ
亭	チン	テイ
亮	アキ	アキラ	アキラカ	キョウ	スケ	タスク	フサ	マコト	ヨシ	リョウ
亯	ウ	キョウ	コウ
亰	キョウ	キン	ケイ	ミヤコ
亳	ハク
亶	アツ	セン	タン	ホシイママ
亹	ウツク	ツト	ビ	ボン	ミ	モン
人	ジ	ジン	ト/ド	ニン	ネ	ヒコ	ヒト	ビト	フミ	リ
什	シュウ/ジュウ
仁	キミ	ク	サト	シノブ	ジ	ジン	ト	ニ	ニン	ノリ	ヒト	ヒトシ	ヒロ	マサ	マサシ	ヤス	ヨシ
仂	ドウ	ハタラ	リキ	リュク	リョク	ロク
仃	テイ
仄	カタム	ソク	ホノ/ボノ
仆	タオ	フ
仇	アタ	アダ	カタキ/ガタキ	キュウ	グ	ツレアイ
今	イマ	キン/ギン	コン	ナ
介	カイ	スケ	ユキ
仍	シキリニ	ジョウ	ナオ	ニョウ	ヨ	ヨル
从	シタガ	ショウ	ジュ	ジュウ	ヨリ
仏	フツ/ブツ	フランス	ブツ/ブッ	ホト/ホド	ホトケ/ボトケ
仐	カサ	サン
仔	コ/ゴ	シ	タ
仕	シ/ジ	ツカ/ヅカ	ツカマツ
他	タ	ホカ
仗	ジョウ	チョウ	ツエ	ツワモノ	マワリ	ヨル
付	ツ/ツク/ヅ	ツキ/ヅキ	ツケ/ヅケ	ツケタリ	ヅ/ヅク	フ/プ
仙	セン/ゼン	セント	ソマ	ノリ
仚	ケン	トブ
仛	オトメ	タ	タク	ヨ
仞	ジン	ハカ
仟	カシラ	セン	チ
仠	カン	ソコ
仡	イサ	キツ	コチ
仢	シャク	チャク	テキ	ハク	マルキバシ
代	カ/ガ	カワ/ガワ	シロ/ジロ	ス	タイ/ダイ	ヨ
令	ノリ	リョウ	レ	レイ
以	イ	モ	モチ	モッ
仨	サ
仭	ジン	ハカ
仮	カ/ガ	カリ	ケ
仯	ショウ	ソウ	チイ	ビョウ	ミョウ
仰	アオ/アオノ	オ	オオ	オッシャ	ギョウ	コウ/ゴウ	ノ/ノケ	ム
仱	キョウ	キン	ケン	ゴン	ツツシ	ホ
仲	チュウ	チュン	ツヅキ	ナカ	ナカツ
仳	ヒ	ワカ
仵	ア	アエテ	オナジ	コ	サカ
件	クダリ	クダン	ケン
价	カイ
任	サ	ツトム	トウ	ニン	ヒデ	マカ	マカセ
份	アキ	ウルワ	ヒン	フン
仾	テイ	ヒク
仿	クラ	サマヨ	ナラ	ホウ
伀	オオヤケ	オソ	シュ	ショウ
企	キ	クワダ	タク	タクラ
伂	ハイ
伃	ウツク	ヨ	ヨシ
伈	オソ	シン
伉	コウ	タグ	ナラ
伊	イ	イタリア	イト	カレ	コレ	タダ	ダ	ヨシ
伋	キビ	キュウ	ロウ
伌	ア	アイ	クル
伍	アツム	イツツ	クミ	ゴ
伎	キ/ギ	ワザ	ワザオギ
伏	フ/フス/ブ/プ	フク/フッ/ブク/プク	フシ/ブシ	フセ/ブセ
伐	ウ	カ	キ/キリ	ソム	ハツ/バツ	バツ/バッ	ボチ
休	キュウ	ヤス/ヤスミ
伒	キン	コン	タス
伕	フ	ムスメムコ
伖	カネグラ	トウ	ド
众	オオ	ギン	ゴン
伙	カ	ヒ	ホ
会	ア	アイ	アツ	イ	エ	カイ	クワ
伜	サイ	セガレ	ソチ	ソツ
伝	ツタ/ツタイ/ツタウ/ヅタ	ツタエ	ツダ	ツテ/ヅテ	ツトウ	テン/デン
伮	ツト	ド
伯	イキ	エキ	カ	キ	ハ	ハク/ハッ/パク	ヒロ
估	アキナ	アタ	コ
伱	シカリ	ジ	ソノ	ナンジ	ニ	ノミ
伳	オゴ	セチ	セツ
伴	トモ	トモナ	ハン/バン/パン
伵	キ	キョク	ケキ	サビ	シズ
伶	リョウ	レ	レイ	ワザオギ
伷	チスジ	チュウ	ヨツギ
伸	シン	ノ/ノシ/ノバ/ノビ	ノブ	ノボル	ヨボル
伹	ショ	ツタナ
伺	ウカガ	シ
伻	スキ	スミ	ツカ	トリ	ヒョウ	ホウ
似	ジ	ニ/ニア/ニセ	ニタ	ヒ
伽	カ/ガ	キャ/ギャ	トギ
伾	オオ	ハイ	ヒ	ヘ
佀	ジ	ニ	ヒ
佂	オソレアワ	ショウ	セイ
佃	ツクダ	テン/デン
但	タジ	タダ	タダシ	タン
佇	タ	タタズ	タタズマ	チョ
佈	アマネ	フ	ホ
佉	カ	キャ	キョ	コ
佋	ショウ	タス
佌	シ	チイ
位	イ	クライ/グライ	ゾキ	ミ
低	テイ	ヒク
住	シ	ジュ	ジュウ	ス/スマ/ズ	スミ/ズミ	ズマ	チュウ/ヂュウ
佐	サ/ザ	スケ	タスク
佑	ウ	スケ	タス	タスク	ユ	ユウ
佒	アオ	アオム	オウ	タノ	ヨウ
体	カタチ	カラダ	タイ/ダイ	テイ	ナリ
佔	ウカガ	シ	セン	チン	テン	ミル
何	アガ	イズ	カ	ナ	ナニ	ナン
佖	タダ	ナラ	ヒツ	ビチ
佗	イ	タ	ホカ	ワ	ワビ
佘	シャ
余	アマ/アマリ	アマル	アンマ	ヨ
佚	イツ/イッ	タノシ	テツ	ノガ
佛	サラギ	フツ/ブツ	ブツ/ブッ	ホトケ
作	クリ	サ	サカ	サク/サッ/ザク	ツク/ツクル/ヅク	ヅクリ	トモ	ナオ	ハギ	マサカ
佝	ク	コウ	セムシ
佞	オモネ	ネイ	ヨコシマ
佟	ズ	トウ
你	シカリ	ジ	ソノ	ナンジ	ニ	ノミ
佣	ヨウ
佩	オ	オビダマ	ハ	ハイ/パイ
佪	エ	カイ	サマヨ
佬	オオ	リョウ	ロ	ロウ
佮	ア	コウ
佯	イツワ	ヨウ
佰	オサ	ハク	ヒャク
佱	ノリ	フラン	ホウ
佳	カ	ケイ	ヨ	ヨシ
併	アワ	アワセ	シカ	ヘイ/ペイ
佶	キチ	キツ/キッ	タダシ
佷	ギン	コウ	コン	モト
佸	ア	アツ	イタ	カツ	ガチ	ツト
佹	カサ	キ	ササ	モト	ヨ
佺	セン
佻	カル	ジョウ	チョウ	ヨウ
佼	ウツク	キョウ	コウ
佽	オヨ	カワルガワル	シ	スバシコイ	タス	トシ	ナラ
佾	イチ	イツ	ヤス
使	シ	ツカ/ヅカ	ツカイ/ヅカイ
侁	イ	シン	ツカ
侂	タク	タノ	ヨ
侃	アキラ	カン	タダシ	ツヨ
侄	オロ	カタ	シチ	シツ	テツ	トド
侅	カイ	ムセ
來	キ	キタ	ク	タイ	ライ
侈	オゴ	シ
侉	ア	オゴ	カ	ケ	ホコ
侊	コウ	サカン	テ	ミツ
例	タト	レイ
侌	イン	カゲ
侍	カミ	サムライ/ザムライ	シ/ジ	ハベ
侎	イツク	ビ	ミ
侏	シュ
侐	キ	キョク	ケキ	サビ	シズ
侑	アツム	ウ	スス	ススム	タス	ユ	ユウ	ユキ
侒	アン	ヤス
侓	オオ	ロチ	ロツ
侔	シタガ	ソロ	ツト	ト	ハカ	ヒト	ボウ	ム
侖	オモ	リン	ロン
侗	イタ	オロ	カタチ	ズ	ツ	ツツシ	トウ	ナオイ	マコト
侘	タ	ホコ	ワ	ワビ
侙	オソ	チキ	チョク
侚	シメ	シュン	スミ	ツカ	トナ	フカ
供	キョウ	ク/グ	クウ	ソナ/ソナエ	トモ/ドモ
依	イ	エ	ヨ	ヨリ
侞	シタガエナ	ジョ	ニョ	ヒト
侟	セン
侠	オトコダテ	キャン	キョウ
価	アタイ	カ	ケ
侫	オモネ	ネイ	ヨコシマ
侭	コトゴトク	ジン	ママ
侮	アナズ	アナド	ブ
侯	コウ	ホウ
侲	ウマカイ	シン	ハシタ	ヨイワラベ	ワラベ
侵	オカ	シン
侶	トモ	リョ	ロ
侷	キョク	ゴク	セマ	タケガヒク
侹	オトコギ	ジョウ	チョウ	ツツシ	テイ	ナオイ
侻	カナウ	カル	タイ	タチ	タツ	タヤス	テ	テガル	ヨイ
侼	ウラ	ツヨ	ホツ	ボチ
侽	オ	オトコ	ダン	ナン
侾	オオ	キョウ	コウ
便	タヨ/ダヨ	ビン	ベン
俀	タイ	テ	ヨワ
俁	オオ	グ
係	カカ/カカワ	カカリ/ガカリ	ケイ
促	ウナガ	セク	ソク
俄	ガ	ニワ	ニワカ
俅	イタダ	キュウ	グ
俆	オソイ	ショ	ユル
俈	コク
俉	ア	ゴ	ムカ
俊	シュン	スグル	トシ/ドシ
俋	ジュウ	タガヤ	チュ	チュウ	ユウ
俌	タス	フ	ホ
俍	サマヨ	リョウ	ロウ
俎	イタ	ショ	ソ	マナイタ
俏	カタド	ショウ	ニ	ミメヨイ	ヤツ
俐	カシコ	リ
俑	トウ	ユウ	ヨウ
俒	カン	ケガ	コン	マッタシ
俔	ウカガ	ケン	タト
俗	ゾク/ゾッ
俘	トリコ	フ
俚	イヤ	リ
俛	フ	ベン	メン
俜	オトコダテ	ツカ	ビョウ	ヘイ
保	ウ	オ	タモ	タモツ	ブ	ホ/ボ/ポ	ホウ	モリ	ヤス	ヤスシ
俟	シ	マ
俠	オトコダテ	キャン	キョウ
信	シ	シガ	シナ	シノ	シブ	シン/ジン	トキ	ノビ	ノブ	マコト
俢	オサ	シュ	シュウ
俣	バタ	マタ
俤	オモカゲ	テイ
俥	クルマ
修	オキ	オサ	オサム	シュ	シュウ	ナカシ	ナガ	ノブ
俯	ウツブ	ウツム	フ
俰	カ	ヤワ	ワ
俲	コウ	ナラ
俳	ハイ/パイ
俵	タワラ/ダワラ	ヒョウ/ビョウ/ピョウ
俶	シュク	テキ	ハジメ	ヨイ
俸	ホウ/ポウ
俺	エン	オレ	ワレ
俼	イク	カイ	カユ	シュク	ヒサ
俽	キン	コン	ヨロコ
俾	カシズク	シム	ヒ	フ	ヘイ
俿	カタタガ	ジ	チ
倀	クル	ジョウ	タオ	チョウ	トウ
倁	ジ	チ	ユ
倄	エ	カイ	ギョウ	コウ	ソコ	モト
倅	サイ	セガレ	ソチ	ソツ
倆	タクミ	リョウ
倇	エン	オン	スス	タノ	ヨロコ
倉	クラ/グラ	ソウ
倊	クル	ス	ソウ
個	カ/ガ	コ
倌	カン	トネリ
倍	バイ	ベ	マス
倎	アツ	テン
倏	シュク	タチマチ
倐	シュク
們	トモガラ	モン
倒	コ	サカサ	サカサマ	サカシマ	タオ/ダオ	トウ/ドウ
倓	シズ	タン	ヤス
倔	クツ	ツヨ
倖	コウ	サイワ	シアワ
倗	タス	ホウ	ユダ	ヨ
倘	ショウ	タチモトホ	トウ	モシ
候	コウ	ソウロ	ソウロウ
倚	イ	キ	タノ	ヨ
倛	アザム	キ
倜	オロ	スグ	ソム	チャク	チュウ	テキ
倝	カガヤ	カン
倞	アキ	オウ	キソ	キョウ	ケイ	コウ	ツヨ	トオ	モト	リョウ
借	カ/カリ/ガ	カリ/ガリ	シャク/シャッ
倡	ショウ	トナ	ワザオギ
倢	サトイ	ショウ	スコ	ハヤ
倣	ナラ	ホウ
値	アタ	アタイ	ジ	チ/ヂ	ネ
倥	コウ	ヌカ
倦	アキ	アグ	ウ	ケン	ツカ
倧	ス	ソウ
倨	オゴ	キョ	コ
倩	ウツク	セイ	セン	ツラツラ
倪	ガイ	キワ	ゲイ
倫	トモ	ノリ	ヒトシ	ヒロ	ミチ	リン
倬	タク
倭	イ	シタガ	マサ	ヤス	ヤマト	ワ
倮	カ	カタヌ	ゲ	スハダ	セマ	ハダカ	ラ
倰	アザム	オカ	ナガ	リョウ	ロウ
倲	オロカ	ツ	トウ
倳	オ	サ	サシコ	シ
倵	ブ	ム
倶	ク/グ	トモ
倹	ケン	ツヅマヤカ	ツマ
倻	ヤ
偀	エイ	ハナブサ
偁	ア	ショウ
偂	スス	セン
偃	エン	フ
偅	コドモ	シュ	ショウ	トウ
偆	アツ	ウゴメ	シュン	チュン	ト
假	カ	カリ	ケ/ゲ
偈	イコ	ケイ	ケツ	ゲ
偉	イ	エラ	ヒデ
偊	ウ	ク	クグ	ツツシ
偌	コノヨウナ	コノヨウニ	ジャ	ニャ
偎	エ	シタ	チカヨ	ナジ	ホノ	ワイ
偏	カタヨ	ヒトエ	ヘン/ベン
偐	ガン	ゲン
偑	フ	フウ
偒	トウ	マッス
偓	アク	カカ
偕	カイ	トモニ
偖	サテ	シャ
偗	ショウ	セイ	マッスグ
偙	クル	スグ	タイ	テイ
做	サ	サク	ソ	ツク	ナ
停	テイ	ト/トマ	トド
偟	イトマ	オウ	コウ	サマヨ	タタズ	タチモトホ
偠	シナヤ	タオヤ	ヨウ
偢	イツク	ウレ	ショウ
偣	アン	エン	キヨ
健	カツ	ケン	シタタ	スコ	タケ	タケシ	タケル	タテ	ツヨシ	トシ	ヤス	ヤスシ
偦	ショ	トオ
偧	タ	ハ
偪	セマ	ヒキ	ヒツ	ヒョク	フク	ムカバキ
偬	クル	ソウ
偭	カナ	ソム	ベン	ム	メン
偰	キヨ	セチ	セツ
偱	シュン	ノ
偲	サイ	シ	シノ
側	カワ/ガワ	ソク/ソッ	ソバ
偵	テイ
偶	グウ	タマ
偸	チュウ	ツ	トウ	ヌス
偽	イツワ	カ	ギ	ニセ
傀	オオキ	カイ
傁	オキナ	ス	ソウ
傃	ソ	マモ	ム
傄	カツ	ケチ	スコ
傅	カシズ	ツク	デン	フ	モリ
傆	カン	ゲン	コザカ
傊	イン	マサ	ユタカ
傍	オカ	カタワ	ソバ	ハタ	ビ	ボウ	ワキ
傎	クル	サカサマ	テン
傏	オゴ	トウ
傐	コウ
傑	ケツ/ケッ	スグ	スグル	タケ	マサ	マサル
傒	アヤウ	ケイ	ツナ
傓	サカン	セン
傔	ケン	シタガ	ツカ	ハベ
傖	イナカモノ	イヤ	イヤシイモノ	ショウ	ソウ
傘	カサ/ガサ	サン
備	ソナ/ソナエ/ゾナ	ツブサ	ビ	ビッ	ビン
傚	コウ	ナラ
傛	カガ	ユ	ヨウ
傜	エダチ	ツカ	フゾロ	ヨウ
傞	サ
傟	オウ	モト
傠	ウ	カ	キ	ソム	ハツ	ボチ
傡	ナ	ナラ	ヘイ	ホウ
傢	カ	カグ
傪	サン	ヨイ
催	サイ/ザイ	モヨウ	モヨオ
傭	アタ	チョウ	ヒト	ヤト/ヤトイ	ヨウ
傯	クル	ソウ
傰	オモネリクミ	トモ	トモガラ	ホウ
傲	アナド	オゴ	ゴウ
傳	ツタ	ツテ	ツトウ	テン/デン
傴	ウ	カガ	ク	セムシ
債	サイ
傷	イタ	キズ	ショウ/ジョウ
傹	アキ	オウ	キソ	キョウ	ケイ	コウ/ゴウ	ツヨ	トオ	モト	リョウ
傺	タイ	テイ	ト	トド
傽	オドロ	ショウ
傾	カシ	カタ	カタブ	カタム	ケイ
僀	クル	スグ	タイ	テイ
僂	カガ	ル	ロウ
僃	ソナ	ビ
僄	カル	カロ	スバヤ	ヒョウ
僅	キン	ゴン	ワズ	ワズカ
僇	ハジ	ハズカシ	リク	ル	ロク
僉	セン	ミナ
僊	セン
僌	オサ	ヨウ
働	ドウ	ハタラ/バタラ
僎	カズ	カゾ	シュン	セン	ソナ
像	カタ	ゾウ
僐	オツクリ	セン
僑	キュウ	キョウ
僓	エ	カイ	シタガ	タイ	テ	ナラ	ミヤ
僔	アツ	ウヤウヤ	オオ	ソン
僕	シモベ	ボク
僖	キ	ヨロコ
僘	ショウ	タカ	ヒロ	ホガ
僚	リョウ
僜	ア	ショウ	チョウ	ト	トウ	ノボ
僝	アラワ	サン	ゼン	ソナ	ノノシ
僞	イツワ	カ	ギ	ニセ
僟	キ	ゲ	チカ	ヨクツツシ
僢	シュン	セン	ソム	マ	ムカイア
僣	オゴ	シン	セン
僤	アキ	アツ	セン	タチ	タツ	タン	ハヤ	ユ
僥	キョウ/ギョウ
僦	アツ	オク	カ	シュ	シュウ
僧	ソウ/ゾウ
僨	オ	タオ	フン	ホン	ヤブ
僩	カン	ゲン	タケダケ
僭	オゴ	シン	セン
僮	シモベ	トウ/ドウ	ワラベ
僯	ハジ	リン
僱	コ	ヤト
僵	キョウ	タオ
僶	ツト	ビン	ミン
價	アタイ	カ	ケ
僺	ショウ	ナガ
僻	ヒ	ヒガ	ヘイ	ヘキ
僾	アイ	カク	カナ	ホノ	ムセ
儀	ギ	タダシ	ノリ	ヨシ
儁	シュン	スグ
儂	カレ	ドウ	ノウ	ワシ
儃	セン	タタズ	タン	ホシイママ	ヨウ
億	オ	オク/オッ
儆	イマシ	ケイ	ショウ
儇	アザム	カシコ	ケン	サトイ	マト
儈	カイ	ケ	ナカガイ
儉	ケン	ツヅマヤカ	ツマ
儋	コガメ	セン	タン	ニナ
儌	イツワ	ウカガ	キョウ	モト	ユ
儍	サ
儎	サイ	ノ
儐	アイサツ	ウヤマ	スス	ヒン
儒	ジュ
儔	ジュ	チュウ	トモガラ
儕	サイ	セイ	トモガラ
儖	ラン
儗	カイ	ギ	クラ	ナゾラ
儘	コトゴトク	ジン	ママ
儙	ケン	ヒラ
儚	クラ	ハカナ	ボウ	モウ
儛	ブ	マ	ム
儜	ドウ	ナヤ	ニョウ	ネイ	ヨワ
儝	ケイ	マツ
儞	オレ	シカリ	ジ	ソノ	ナンジ	ニ	ノミ
償	ショウ	ツグナ
儡	ライ
儣	コウ
儧	アツ	サン
儨	シチ	シツ	タダ
優	ウ	スグ	スグル	マサ	マサル	ヤサ	ユ	ユウ	ユタカ	ヨシ
儬	シン
儭	イタ	ウラ	オソ	シク	シン	チカ
儯	トウ	ナガ
儱	ウヤムヤ	デキア	リュ	リョウ	ル	ロウ
儲	タクワ	チョ	モウ/モウカ	モウケ
儳	サン	トトノワヌ	ハヤ	ワル
儴	サマヨ	ショウ	ソウ	ヨ
儵	シュウ	ハヤ
儷	ツレアイ	ナラブ	レイ
儸	サバ	ラ
儹	アツ	サン
儺	オニヤライ	ダ	ナ
儻	アルイハ	スグ	トウ	モシ
儼	イカメ	オゴソカ	ゲン
儿	ガイ	ジン	ニン	ニンニョウ	ヒトアシ
兀	コツ
允	イン	ジョウ	スケ	チカ	トモ	ノブ	マコト	マサ	ミツ	ユルス	ヨシ
兂	カンザシ	サン	シン
元	ガン	ゲン	チカ	ハジメ	ハル	モト	ユキ	ヨシ
兄	アニ	エ	キョウ	ケイ	セ	ニイ	ヨシ
充	ア	アツ	ジュウ	タカシ	ノブ	マサ	ミ/ミチル	ミチ	ミツ	ミツル	ヨシ
兆	キザ	チョウ
兇	オソ	キョウ	ワル
先	サキ/ザキ	セン	ポン	マ
光	アキ	アキラ	コウ	コオ	テル	ヒカ/ヒカル/ビカ	ヒカリ/ビカリ	ヒコ	ミ	ミツ	ミツル
兊	エイ	エツ	タイ	ダ	ヨロコ
克	カ	カツ	コク/コッ	マサル	ヨシ
兌	エイ	エツ	タイ	ダ	デ	ヨロコ
免	マヌカ	マヌガ	メ	メン
兎	ウ	ウサギ	ツ	ト/ド
兏	オサ	チョウ	ナガ
児	ゲイ	コ	ゴ	ジ	チゴ	ッコ	ニ	ル
兒	ゲイ	コ	ジ	チゴ	ニ
兓	サン	シン	スルド	タス
兔	ウサギ	ツ	ト
兕	シ
兗	エン	クク	タダ	マコト
兘	シ	ハジ
党	トウ/ドウ	ナカマ	ムラ
兜	カブト	ト	トウ
兟	シン	スス
兢	オソ	キョウ	ツツ
兤	アカ	コウ
入	イ/イレ	イリ	イル	ジュ	ニ	ニュウ	ノ	ハイ	リリ
兦	ナ	ホロ	ボウ	モウ
全	アキラ	スベ	ゼン	タケ	チョン	マサ	マッタ	マット
兩	フタツ	リョウ
兪	シカリ	ツ	トウ	ユ
八	ナ	ハ	ハチ/バチ/パチ	ハッ/バッ	ハツ/ハッ	ヤ	ヤチ	ヤツ/ヤッ/ヤヅ	ヨウ
公	アキラ	イサオ	オオヤケ	キ	キミ	キン	ク/グ	コウ	タカ	タダシ	トモ	ヒロ	マサ
六	ク	ム	ムイ	ムツ/ムッ	リク/リッ	ロク/ロッ	ロツ
兮	ケイ
共	キョウ	トモ/ドモ
兵	ツワモノ	ヒョウ/ビョウ	ヘ/ベ	ヘイ/ペイ
其	キ/ギ	ゴ	ソ	ソノ	ソレ/ゾレ
具	グ	ソナ	ツブサ	トモ
典	スケ	ツネ	テン/デン	ノ	ノリ
兼	カ/ガ	カネ/ガネ	ケン
兾	キ	コイネガ
冀	キ	コイネガ	コイネガワ
冂	エナガマエ	キョウ	ケイ	ケイガマエ	ドウガマエ	マキガマエ
冃	オオ	ズキン	ボウ	モウ
冄	アヤ	ゼン	ネン
内	イト	ウチ	タダ	ダイ	チ	ナイ	ノチ
円	エン	ツブラ	ノブ	マド	マドカ	マル	マロ	ミツ
冉	アヤ	ゼン	ネン
冊	サク/サッ/ザク	サツ	フミ
冋	エナガマエ	キョウ	ケイ	ケイガマエ	ドウガマエ	マキガマエ
册	サク	サツ	フミ
再	サ	サイ	フタ	フタタ
冎	カ	ケ	サ	ワ
冏	アキラカ	キョウ	ケイ	ソウ
冐	オカ	ボウ
冑	カブト	チュウ	ヨロイ
冒	オカ	ボウ
冓	カマ	コウ
冕	カンムリ	ベン	メン
冖	ベキ	ベキカンムリ	ワカンムリ
冗	ジョウ
冘	イン	ウタガ	オコタ	タメラ	ユ
写	ウツ	ウツシ	シャ/ジャ
冝	ギ	ヨロ
冠	カ	カップ	カブ	カブリ	カン	カンムリ	マサル
冡	オオ	ボウ	モ
冢	オオ	チョウ	ツカ
冣	サイ	シュ	ツマ	モット
冤	エン
冥	クラ	ミョウ	メイ
冦	アダ	コウ
冨	ト	トミ/ドミ	フ/ブ	フウ
冩	ウツ	シャ
冪	ベキ
冫	コオリ	ニスイ	ヒョウ
冬	トウ/ドウ	フユ
冭	タ	タイ	タチ	タツ	ナメ	ヤス
冰	コオ	コオリ	ヒ	ヒョウ
冱	コ/ゴ	コオ	サ	ヒ
冲	オキ	オキツ	チュウ	ワク
决	キ	ケチ	ケツ	サ
冴	コ/ゴ	コオ	サ	サエ	サエル	ヒ
况	イワ	オモムキ	キョウ	マシ
冶	イ	ジ	ヤ
冷	サ/ザ	ツメ	ヒ/ヒエ/ヒヤ/ビ	レイ
冸	ト	ハン
冺	ビン	ベン	ホロ	ミン	メン
冼	サム	ショウ
冽	キヨ	キヨシ	レイ	レツ
冾	キョウ	ヤワ
冿	スス	セン
凂	バイ
凄	サイ	サム	スゴ	スサ	セイ
凅	カ	カク	コ	コオ
准	ジュン	ナゾラ
凈	ショウ	ソウ	ヒヤヤカ
凉	ウス	スズ	ヒヤ	マコトニ	リョウ
凋	シボ	チョウ
凌	シノ	シノギ	リョウ
凍	イ/イテ	コオ	コオリ	コゴ	シ/シミ	トウ
减	ゲン	ヘ
凑	アツ	ソウ	ミナト
凒	カイ	ギ	ゲ	サム	シロ
凓	サム	リチ	リツ
凕	コオ	ベイ	ミョウ
凖	ジュン	ナゾラ	ノリ	ヒト	ミズモリ
凘	サイ	シ	セイ
凛	キビシ	リン
凜	キビシ	リン
凝	ギョウ	コ/コリ	コゴ	シコ
凞	キ	ヤワ
几	キ/ギ	キニョウ	ツクエ
凡	オウヨ	オヨ	スベ	ナミ	ハン	ヒロ	ボン	ミナ
凢	オオヨ	オヨ	スベ	ハン	ボン
凥	イ	オ	オキ	キョ	グ	コ	スエ
処	オ	コ	ショ	トコロ/ドコロ	ド
凧	イカノボリ	タコ/ダコ
凩	コガラシ
凪	ナ	ナギ
凭	ヒョウ	ヘイ	モタ/モタレ	ヨ
凮	カザ	カゼ	フ	フウ
凰	オウ	オオトリ	コウ
凱	カイ/ガイ	カチドキ	ヤワラグ
凲	カン	ケン
凳	コシカ	トウ
凴	ヒョウ
凵	ウケバコ	カン	カンニョウ
凶	キョウ
凷	カイ	カタ	ケ	ツチクレ
凸	デコ	トツ/トッ
凹	オウ	クボ	ヘコ	ボコ
出	イ	イズ	イズル	イヅ	イデ	シュツ/シュッ	ジ	スイ	スツ/スッ	ダ/ダシ/ダシキ	テン/デン	デ/デア/デハ	デッ
函	イ	カン	ハコ/バコ
凾	イ	カン	ハコ
刀	カタナ/ガタナ	キ/ギ	ソリ	チ	ト	トウ	ワキ
刁	チョウ
刂	トウ	リットウ
刃	キ	ジン	チ	ト	ニン	ハ/バ	ヤイバ
刄	キ	ジン	ニン	ハ	ヤイバ
刅	キズ	ショウ	ソウ	ツク	ハジ
分	イタ	フン/ブン	ブ	ワ/ワカ	ワケ
切	キ/キレ/ギ	キッ/ギッ	キツ/キッ	キリ/ギリ	キレ/ギレ	サイ	セツ/セッ
刈	カ/カル/ガ	カイ/ガイ	カッ	カリ/ガリ
刊	カン
刋	カン	キ	ケズ	セン
刎	クビハ	ハ/ハネ	ハネ/バネ	フン
刑	オサカ	ギョウ	ケイ
划	カ	カマ	ゲ	サ	サオサ
刓	エ	ガン	グン	ケズ	スリヘ	タ
刔	エグ	ケツ
刕	サ	ライ	リ	レイ
刖	アヤウ	カツ	キ	グチ	ゲツ	ゴチ	ゴツ
列	ツラ	ナラ	レ	レツ/レッ
刘	コロ	リュウ	ル
初	ウイ	ウブ	シ	ショ	ソ/ソメ/ゾ	ソメ/ゾメ	ハジ	ハジメ	ハツ/ハッ
刢	サ	リョウ	レイ
判	ハン/バン/パン	ワ	ワカ
別	ベツ/ベッ	ワ/ワケ	ワカ
刧	オビヤ	キョウ	コウ/ゴウ
刨	ケズ	ビョウ	ホウ
利	カガ	キ	キキ	ト	トギ	トシ	ノリ	ミ	リ	リイ
刪	ケズ	サン
刮	カツ	ケズ	コソ	コソギ
到	イタ	トウ
刱	キズ	ショウ	ソウ	ハジ
刲	エグ	ケ	ケイ	コロ	サ
刳	エグ	エグリ	ク/グ	コ
刵	ゲイ	ジ	ニ	ミミキリ
制	セイ
刷	サツ/サッ	ス/スリ/ズ	ズリ	ハ/バ
券	ケン
刹	サツ	セチ	セツ
刺	サ/サス/ザ	サシ	シ	トゲ
刻	キザ	コク/コッ	トキ
刼	キョウ
剃	ス	ソ/ゾ	テイ	マイ
剄	クビキ	ケイ
剅	サ	ツ	トウ	ル	ロウ
則	スナワチ	ソク/ソッ	ノット	ノリ
剉	カドヲト	クジク	サ
削	ケズ	ゲ	サク	ソ	ハツ
剋	カツ	コク
剌	モト	ラツ
前	サキ/ザキ	サト	ゼン	マイ	マエ
剏	ショウ	ソウ	ハジ
剔	エグ	エグリ	ソ	テイ	テキ
剕	アシキ	ヒ
剖	ボウ
剗	ケズ	サン	セン
剘	キ	サ	タダ	マコト
剚	オ	サ	サシコ	シ
剛	カタ	コウ/ゴウ	ゴ	タカ	タカシ	タケ	タケシ	ツヨ	ツヨシ	ヒサ	マサ	ヨシ
剜	エグ	ケズ	ワン
剞	キ	キザ
剟	ウ	ケズ	サキト	ソグ	タチ	タツ	テチ	テツ
剠	イレズミ	カスメト	ケイ	ショウ	リョウ
剡	エン	ケズ	スルド	スルドク	セン
剣	ケン	ツルギ
剤	カル	ケズ	ザイ	スイ	セイ
剥	ハ/ハガ/ハゲ/パ	ハギ	ハク	ヘ	ヘズ	ホク	ム/ムキ
剦	アン	エン	オオ
剩	アマ	アマツサエ	ジョウ
剪	キ/キリ	セン	ツ	ハサ
剮	カ	ケ	サ	ワ
副	ソ	ソイ	ソエ/ゾエ	フク/フッ
剰	アマ	アマッサ	アマツサエ	ジョウ
剱	ケン	ツルギ
割	カツ/カッ	サ	ワ/ワレ	ワリ
剳	サ	サツ	チョウ	トウ
剴	カイ/ガイ
創	キズ	ケズ	ショウ	ソウ	ツク/ヅク	ハジ	ハジメ
剷	ケズ	サン	セン
剸	キ	サ	セン	タ	タン	ホシイママ
剹	キョウ	ク	ケズ	コロ	リク	リュウ	ロク
剽	オビヤ	サス	ヒョウ
剿	ショウ	ソウ
劀	カツ	ケズ
劂	クチ	ケ	ケイ	ケズ	ケツ
劃	カギ	カク/カッ	ワ
劅	タク
劇	ゲキ
劈	サク	ツンザ	ヒャク	ヘキ
劉	コロ	ノブ	ミズチ	ラウ	リュウ	ル
劊	カイ	カツ	ケ	タ
劌	ア	ケ	ケイ	サ	ソコ	トゲ	ハリ
劍	ケン	ツルギ
劑	カル	ケズ	ザイ	スイ	セイ
劒	ケン	ツルギ
劓	ギ	ゲイ	サ	ハナキ	ハナキリ
劔	ケン	ツルギ
劕	シチ	シツ	タダ	タチ	チ	モト	ワリフ
劖	ケズ	サン	タ
劗	キ	サン	セン	ヘ
劘	ケズ	スル	バ	ビ	マ	ミ	ワ
劚	キ	チャク	チョウ	チョク
力	ジカラ	チカラ/ヂカラ	ツトム	リイ	リキ	リョク
劜	アツ	エチ	ツヨ
功	イサ	イサオ	カツ	ク	クヌ	グウ	コウ	コト	ツトム	トシ	ノリ	ヨシ
加	カ/ガ	カナダ	クワ
劣	オト	レツ/レッ
劤	キン	コン	チカラ	ロク
劥	キョウ	コウ	ツヨ
劦	キョウ	トトノ	ニワカ	リョウ
劧	カタ	シ
助	ジョ	ス	スケ	タス
努	ツト	ツトム	ド
劫	オビヤ	キョウ	クウ	コウ/ゴウ
劬	ク	ツカ
劭	ショウ	ツト
劯	ショ	ツヨ
劰	ツト	バク	マク
励	ハゲ	レイ
労	イタ	イタワ	ツカ	ネギラ	ロウ
劵	ケン	テガタ	ワリフ
劶	ク	コウ	ツト
劷	スス	ヨウ
劸	ア	アイ	セマ
効	キ	キキ	キキメ	コウ	ナラ
劺	ススメハゲ	ボウ	ム
劻	アワ	キョウ	コウ
劼	カツ	ケチ
劽	カ	レチ	レツ
劾	ガイ
勀	カツ	コク	ツト
勁	ケイ	ツヨ
勃	オコ	ニワカニ	ホツ/ボツ	ボツ/ボッ
勄	サトイ	ビン
勅	イマシ	チョク/チョッ	テ	ノリ	ミコトノリ
勆	ツヨ	ロウ
勇	イサ	イサミ	イサム	オ	ハヤ	ユウ
勈	イサ	ヨウ
勉	ツト	ツトム	ツトメ	ヒコ	ベン	マサル	ヤツ
勌	ウ	カン	ケン	ツト
勍	ケイ	ツヨ
勏	ツト	ブ	ホウ
勑	イタワ	オサ	タダ	チキ	チャク	ライ
勒	クツワ	ロク
勔	スス	ツト	ツトム	ビン	ベン	ミン	メン
動	ウゴ	ドウ	ルギ
勖	キャク	キョク	コク	ツト	ボウ
勗	キョク	ツト	ツトム	ボウ
勘	カ	カン	サトル
務	ツカサ	ツト	ツトム	ミ	ム
勛	イサオ	クン
勜	オ	ツヨ	ヨウ
勝	カ/ガ	カチ/ガチ	カッ/ガッ	カツ/カッ/ガツ	ショウ	スグ	ト	マサ/マサル	ヨシ
勞	イタ	イタワ	ツカ	ネギラ	ロウ
募	ツノ	ボ
勠	アワ	リク
勡	カス	ヒョウ
勢	イキオ	イキオイ	セ/ゼ	セイ/ゼイ	ハズミ
勣	イサオ	シャク	セキ	ツム
勤	イソ	キン	ゴン	ツト/ツトメ/ヅト	ツトム
勥	キョウ	ゴウ	セマ	ツト
勦	ショウ	ソウ
勧	カン	ケン	スス	ススム
勨	ウゴ	ショウ	ユル	ヨウ
勩	イ	イタツキ	エイ	シ	ツカ
勪	ガク	キャク	キョウ	スス
勬	ケン	スコ	ツト
勰	ア	カナ	キョウ
勱	ツト	バイ	メ
勲	イサオ	イサム	クン
勳	イサ	イサオ	クン
勴	タス	リョ	ロ
勵	ハゲ	レイ
勶	ケツ	テツ	デチ	トリサ	ハナ
勷	ジョウ	ニョウ	ハシ
勸	カン	ケン	スス
勹	ツツ	ツツミガマエ	ホウ
勺	シャク/ジャク
勾	カギ	ク	コウ	マ	マガリ
勿	ナカ	ナシ	ブツ	ボツ	モチ	モッ
匀	イン	キン	スク	ヒト
匁	メ	モンメ
匂	オリ	コウ	サギ	ニオ/ニオウ	ニオイ
匃	アタ	カイ	カチ	カツ	コウ
包	オ	カネ	クル/グル	ツツ/ヅツ	ツツミ/ヅツミ	ホウ/ボウ/ポウ
匆	イソガ	ソウ
匈	キョウ
匊	キク	コク	スク	タナゴコロ	ムス
匋	トウ	ヤキモノ	ヨウ
匌	ア	コウ	メグ
匍	ハ	ホ
匏	ヒサゴ	フクベ	ホ	ホウ
匐	フク	ホク
匑	ウヤマ	キク	キュウ	ク	コク
匓	アツ	キュウ	キョウ	ク	ハカ
匕	サジ	サジノヒ	ヒ
化	カ	ケ/ゲ	バ	フ
北	キタ/キダ/ギタ	キタガタ	キラ	ホウ	ホク/ホッ/ボク/ポク	ホツ
匘	ドウ	ノウ	ノウズ
匙	サジ	シ
匚	ハコガマエ	ホウ
匛	キュウ	グ	ヒチギ	ヒツギ
匜	イ	タ	ハンゾウ	ヒサゲ
匝	キョウ	ソウ	メグ
匞	ショウ	タクミ
匟	コウ
匠	ショウ/ジョウ	タクミ/ダクミ
匡	オウ	キョウ	キヨ	スク	タダ	タダシ	タダス	ヒト	マサ	マサシ	ヤス
匣	クシゲ	コウ	ハコ
匥	ハコ	ヘン
匧	キョウ	ハコ
匨	オサ	カク	クラ	ソウ
匩	キョウ	スク	タダ
匪	アラ	カタミ	ヒ/ピ
匫	イツワ	コチ	コツ
匬	ズ	トウ	マス	モタイ	ユ
匭	キ	クク	コ	ハコ
匯	エ	カイ/ガイ	キ	メグ	ワイ
匰	ズシ	タン	ハコ
匱	キ	ヒツ
匲	クシゲ	ハコ	レン
匳	クシゲ	ハコ	レン
匵	トウ	トク	ハコ	ヒツ
匸	カクシガマエ	ケイ
匹	ヒキ/ビキ/ピキ	ヒツ/ヒッ
区	オウ	ク	コウ
医	イ	クスシ
匼	アン	オン	コウ	コビヘツラ	メグ
匽	エン	カク	ドブ	ナビ	ハコ	フ
匾	ウス	ガク	ヒラ	ヘン
匿	カクマ	トク
區	オウ	ク	コウ
十	イ	カ/ガ	ギ	サ	シ/ジ	ジッ	ジュウ	ジュッ	ソ	ソウ	チ	ト	トウ	トオ	ネ	マ	ル	ワ
卂	シン	トブ
千	カズ	セン/ゼン	チ/ヂ	ユキ
卅	サンジュウ	ソウ
卆	オ	シュツ	ソツ/ソッ	ツイニ	ニワカ
升	ショウ	ノボル	マス
午	ウマ	ゴ
卉	キ	クサ	ケ
半	ナカ	ナカバ	ハ/バ	ハン/バン/パン
卋	ウ	セ	セイ	ソウ	ツギ	ツグ	トキ	ヨ	ヨヨ
卌	シジュウ	シュウ	ヨンジュウ
卍	バン	マン	マンジ
卑	イヤ	ヒ/ビ/ピ
卒	オ	シュツ	ソツ/ソッ	ツイニ	ニワカ
卓	ショク	スグル	タカ	タカシ	タク/タッ
協	キョウ
南	ナ	ナミ	ナン	ハ	ミナ	ミナミ	ミマミ
単	タン	ヒトエ
卙	アツ	シュウ	ショウ
博	グレ	ト	ハカ	ハク/バク/パク	ヒロ	ヒロシ	ヒロム
卛	シュツ	ソツ	ヒキ	リツ
卜	ウラ	ウラナ	ウラナイ	ボク/ボッ
卞	ハン	ヘン/ベン
占	ウラ	ウラナ	ウラナイ	シ/ジ	シム	ジメ	セン
卡	カ	サ	ソウ
卣	サケツボ	ユ	ユウ
卥	セイ
卦	ウラカタ	カ	カイ	ケ
卩	セツ	フシヅクリ	ワリフ
卬	キョウ	ゴウ	タカ	ナ	ノゾ
卭	キョウ
卮	サカズキ	シ
卯	アキラ	イ	ウ	シゲル	ボウ	モウ
印	イン	シル	シルシ/ジルシ
危	アブ	アヤ	キ
卲	ショウ	タカ
即	スナワ	ソク/ソッ	ツ
却	カエ	キャク/キャッ	シリゾ
卵	タマゴ	ラン
卷	カン	ケン	マ	マキ
卸	オロ	オロシ	シャ
卹	ウレ	シュチ	シュツ	ソチ	ソツ
卻	カエ	キャク	シリゾ
卾	ウワアゴ	ガク
卿	キミ	キョウ/ギョウ	ケイ
厂	カリガネ	カン	ガンダレ
厃	アオ	エン	ギ	セン	タルキ	ノキ
厄	ヤク/ヤッ	ワザワイ
厇	サ	タク	チャク	ハリツ	ヒラ
厈	カリガネ	カン	ガンダレ
厎	キイ	シ	タイラ	チ	テイ	ト	トイシ	ミガ
厓	カタエ	ガイ	ガケ	キシ	ギ	ゲ	ハテ
厔	ササ	シチ	シツ	ト
厖	オオキ	ボウ
厘	リン
厙	シャ
厚	ア	アカ	アツ/アッ	アツシ	コウ
厝	オク	サク	ジャク	セキ	ソ	トイシ	マ
原	ゲン	タ	ハラ	ハラノ	ハル	バラ	バル	パラ	ラ	ワタ	ワラ
厠	カワヤ	シ	ショク
厡	オカ	ゲン	タズ	ハジメ	ハラ	モト	ユル
厤	オサ	リャク	レキ
厥	クツ	ケツ	ソノ	ソレ
厦	イエ	カ	サ
厨	クリヤ	シュウ	ズ	チュ	チュウ
厩	ウマヤ	キュウ	マヤ	マラ
厪	キン	コヤ	ゴン
厫	クラ	ゴウ
厭	ア/アキ	アン	イト	イヤ	エン	オウ	オサ	オン	ユウ	ヨウ
厮	コモノ	シ
厯	コヨミ	レキ
厰	ショウ
厲	コス	ト	トイシ	ライ	レイ	レチ	レツ
厳	イカ	イカメ	イツ	イツクシ	イヅ	イム	イワオ	オゴソ	キビ	キュウラ	ゲン	ゴン	トシ
厴	エン
厵	ゲン	ミナモト
厶	ゴザ	シ	ボウ	ム	ワタクシ
厷	カイナ	コウ	ヒジ	マル
厸	トナ	トナリ	リン
厺	キョ	コ	サ
去	イ	キョ	コ	サ/サリ/サル/ザ	サル/ザル
厽	カベ	サン	ルイ
叀	カ	セン	ツツシ
参	サン/サンジ/ザン	シン/ジン	マイ	マジワル	ミ	ミツ
參	サン	シン	マイ	マジワル	ミツ
叅	サン	シン	マイ	マジ	ミツ
又	マタ	ヤス	ユウ
叉	サ	サイ	シャ	マタ
及	オイ	オヨ/オヨボ	オヨビ	キュウ/ギュウ	ノ
友	ウ	トモ/ドモ	ド	ユ	ユウ
双	ソウ/ゾウ	タグイ	ナラブ	フ	フタ	フタツ
反	カエ	ソ	ソリ/ゾリ	ゾ	タ/ダ	タン/ダン	ハン	ホ	ホン
収	オサ	オサム	シュウ	ノブ
叏	カイ	ケチ	ケツ	ワ
叒	シタガ	シャク	ニャク
叓	コト	シ	ズ	ツカ
叔	シュク	ヨシ
叕	イ	ゲツ	スミ	ツヅ	テイ	テチ	テツ	ト
取	シュ	ト/トッ/トル/ド	トリ/ドリ	ドル
受	ウ	ウケ	ジュ	ジョ
叙	ジョ	ツイ	ツイデ
叚	カ	ケ
叛	ソム	ハン	ホン
叝	コウ
叞	イ	ジョウ
叟	オキナ	シュウ	ソウ
叠	カサ	ジョウ	タタ	タタミ	チョウ
叡	アキ	アキラ	エイ
叢	クサムラ	ス	ソウ	ムラ/ムラガ
口	ク	クチ/グチ	コ	コウ
古	イニシエ	コ/ゴ	フ	フユ	フル/ブル
句	ク	スク
另	サ	ベツ	リョウ	レイ	ワカ
叧	カ	ケ	サ	ワ
叨	トウ	ミダリニ
叩	コウ	スギ	タタ/ダタ	タタキ	ダタキ	ハタ/パタ	ハタキ
只	シ	タダ
叫	キョウ	サケ
召	ショウ	メ/メシ/メス
叭	ハツ
叮	テイ
可	カ	コク	ベ	ヨシ
台	ウテナ	タイ/ダイ	ツカサ	ワレ
叱	シカ	シチ	シツ/シッ
史	アキラ	アヤ	オ	コ	シ/ジ	チカ	トシ	ナカ	ノブ	ヒサ	ヒト	フミ
右	アキ	ウ	スケ	ミギ	ユウ
叵	スコブル	ツイニ	デキ	ハ
叶	カナ/カナイ/カナウ/カナエ	カノ	カノウ	キョウ	ヨウ
号	ゴウ	サケ	ヨビナ
司	シ/ジ	ツ	ツカ/ヅカ	ツカサ	ツカサド
叺	カマギ	カマス
吁	アア	ウ	ク
吂	オイボ	ボウ	モウ
吃	キツ/キッ	ドモ
各	オノオノ	カカ	カガ	カク/カッ
合	ア	アイ	アウ	アワ	アン	イ	カ/ガ	カッ/ガッ	コウ/ゴウ	ゴオ	ニ	ネ	ヤ	リ	ワイ
吉	エ	キ/ギ	キチ	キツ/キッ	キル	コシ	ト	ヨ	ヨシ
吊	チョウ	ツ/ツリ/ヅ	ツル	ヅリ
吋	インチ	スン	トウ/ドウ
同	オナ	ドウ
名	ト	ナ/ナノ	ミョウ	メイ
后	キサキ	コウ/ゴウ	ゴ
吏	サト	シ	リ
吐	ツ	ツキ	ト/ド	ヌ	ハ	ハキ
向	コウ	コオ	タ	ナ	ム/ムイ/ムキ/ムキア/ムク/ムケ	ムカ/ムカウ	ムカイ/ムガイ	ムカエ	ムキ/ムギ	ムコ	ムコウ
吓	オド	カ
吚	イ	ウメ	キ
君	キミ/ギミ	クン	ミ
吝	オシ	シワ	ヤブサ	リン
吟	ギン
吠	ハイ	ベイ	ホ/ボ	ホエ/ボエ
吡	ソシ	ヒ	ヒツ	ビチ
否	イナ	イヤ	ヒ/ピ
吧	ハ	ヘ
吨	トン
吩	フ	フン
吪	ウゴ	カ	グウ	ゲ
含	ガン	フク/ブク
听	キン	ポンド	ワラ
吭	コウ	ノド	フエ
吮	シュン	ス	セン
启	ケイ	ヒラ
吱	キ	シ
吴	ク	クレ	ゴ
吵	コエ	サエズ	ショウ	ソウ	ビョウ	ミョウ
吶	トツ/トッ	ドモ
吸	キュウ/ギュウ	ス/スイ
吹	スイ	フ/フク/フッ/ブ	フキ/ブキ	フク/ブク
吻	クチサキ	クチワキ	フン/ブン/プン
吼	ク	コウ	ホ
吽	イン	ウン	オン	グ	コウ	ホエ
吾	ア	アガ	ゴ	ワ	ワガ	ワレ
呀	ア	カ/ガ
呂	セボネ	トモ	ナガ	リョ	ロ
呃	アイ	アク	ナ
呄	コク
呆	アキ	アッ	オロカ	ホウ/ボウ	ホケ/ボケ	ボ
呇	ケイ
呈	テイ
呉	ク/グ	クレ/グレ	ゴ
告	イ	コク/コッ	ツ/ツゲ
呍	イン	ウン	オン	グ	コウ	ホエ
呎	シャク	フイイト
呏	ガロン	クオオト	ショウ
呑	トン/ドン	ノ/ノミ/ノン
呞	カミカエ	シ	チ
呟	ゲン	ツブヤ
呢	ジ	ニ
呤	ササヤ	リョウ	レイ
呦	オウ	サケ	ムセ	ユ	ユウ	ヨウ
呧	シカ	ソシ	タイ	テイ
周	アマネ	シュ	シュウ	ス	チカ	ノリ	ヒロ	ビビ	マコト	マワ
呩	コノ	シ	タシナ
呪	シュ/ジュ	シュウ	ズ	ノロ/ノロイ	マジナ	マジナイ
呫	ササヤ	シャベ	ショウ	チョウ	テン	ナ
呭	エイ	シャベ	セチ	セツ	タノ
呮	キ	コシカ
呰	サ	シ
呱	コ
味	アジ	ミ
呴	イキヲカケテアタタ	ク	コウ
呵	カ	シカ	ワラ
呶	カマビス	ド	ドウ
呷	アオ	コウ	ス
呻	ウメ	ウメキ	シン
呼	コ	ヨ/ヨバ/ヨビ	ヨブ
命	イノチ	ミョウ	メイ
呿	アクビ	カ	キョ	キョウ	コ	コウ	ヒラ
咀	カ	ショ	ソ
咁	カン	フク
咃	タ
咄	シカ	トツ/トッ	ハナ	ハナシ/バナシ
咅	ツバヲハイテイナ	トウ
咆	ホ	ホウ
咈	イナ	タガ	ヒツ	ビチ	フツ	ブチ
咉	オウ	フサ
咋	カ	ク	クイ	クラ	サ	サク
和	ア/アエ	アイ	イズ	イズミ	オ	カ/ガ	カズ	カツ	カツリ	カヅ	カノウ	タケ	チ	トモ	ナ	ナゴ/ナゴミ	ニギ	マサ	ヤス	ヤマト	ヤワ/ヤワラ	ヨシ	ヨリ	ワ	ワダコ	ワッ
咍	カイ	タイ	ヨロコ	ワラ
咎	キュウ	コウ	トガ/トガメ
咏	ウタ	エイ	ヨ
咐	フ	ホ
咑	ダ
咒	シュ/ジュ	シュウ	ノロ	マジナ	マジナイ
咕	コ	ブツブツイ
咖	カ
咜	シカ	タ	ト
咟	カク
咡	クチ	クチモト	ジ	ニ
咢	オドロク	ガク
咤	シカ	タ	ト
咥	カ	キ	クワ	テツ
咦	イ	キ	タイ	トイキ
咧	レチ	レツ
咨	アア	シ	ハカ
咩	ビ	ミ
咪	ビ	ベイ	メエトル
咫	シ	タ
咬	カ	コウ	ヨウ
咭	カツ	キツ	ギチ	ケチ
咮	クチバシ	シュウ	チュウ	ツ	トウ
咯	カク	ハ
咱	サ	サチ	サツ	シャ	ワレ
咲	サ/サカ/サキホ/サク/ザ	サキ/ザキ	サク/サッ/ザク	ショウ
咳	カイ/ガイ	シワブ	シワブキ	セ	セキ/ゼキ
咷	ジャク	チュウ	テキ	ドウ	ナ
咸	カン	ゲン	シゲ	ミナ
咹	アチ	アツ	アン	ササヤ	ドモ	ヤ
咺	オソ	クン	ケン
咻	キョウ	ク	コウ
咼	カ	カイ	クウ	クチガユガム	ケ	ユガ	ヨコシマ
咽	イン	エツ	エン	ノ	ノド	ノンド	ムセ
咾	ロウ
咿	イ	ツクリワラ
哀	アイ	アワ	カナ	カナシミ
品	シナ/ジナ	ヒン/ビン/ピン	ホン/ボン/ポン
哂	シン	ワラ
哄	コウ
哆	オオ	オオクチ	シ	シャ	タ
哇	ア	アイ	エ	カイ	ケイ	ワ
哈	ゴウ	ソウ	ハ
哉	カ	カナ	サイ/ザイ	スケ	チカ	トシ	ハジメ	ヤ
哊	イク	ハ
响	キョウ	ヒビ
哎	ガイ
哘	サソ
哠	コウ	シャベ
員	イナ	イン	カズ
哢	サエズ	ロウ
哥	アニ	ウタ	カ	コ
哦	ガ
哨	ショウ	ミハリ
哩	マイル	リ
哪	ダ	ナ
哬	カ	シカ	セ
哭	コク	ナ	ナゲ
哮	コウ	タ	タケ	ホ
哯	ケン	ハ
哲	アキ	アキラ	サト	サトイ	サトシ	サトル	テツ/テッ	テツン	ノリ	ヨシ
哶	バ	ビ	マ	ミ	メ
哺	ハグク	フク	ホ/ポ
哼	オビ	キョウ	コウ
哽	コウ	ムセ
哾	セツ	ナ	ヤチ	ヤツ
哿	カ	ヨイ
唀	イザナ	サソ	シュウ	ユウ
唁	ゲン	ゴン	トムラ
唄	ウタ	バイ
唅	カン	コン	フク	フクマセモノ
唆	サ	ソソ	ソソノカ
唇	クチビル	シン
唈	オウ	ナゲ	ムセ	ユウ
唉	アア	アイ	アオ	イ	イヤイヤコタ	カイ	キ
唌	エン	セン	タン	ナゲ
唍	カン	ゲン	ホホエ
唎	コエ	リ
唏	キ	ナゲ
唐	カラ/ガラ	カロ	タン	トウ/ドウ
唔	ゴ
唕	サワガ	ソウ
唖	ア	アク	オシ
唪	オオゴエ	ブ	ホ	ホウ
唫	ウタウタ	キン	クチヲト	ゴン	ドモ
售	ウ	シュウ
唯	イ	タダ	ユ	ユイ
唱	ウタ	ショウ	トナ
唲	アイ	カタコト	ジ	ニ	ヘツラ
唳	レイ	レツ
唵	アン	オン	フク
唶	サク	シャ	シャク	セキ	ナ
唸	ウナ	ウナリ	テン
唹	オ
唻	ウタウ	ライ
唼	クラ	ショウ	スス	ソウ	ツイバ	フ
唽	シャク	セキ
唾	タ/ダ	ツバ	ツバキ
啀	イガ	イガム	ガイ
啁	シュウ	タワム	チュウ	チョウ	トウ
啄	クチ	タク	ツイバ	ツク	ツツ	トク	ハシ/バシ
啅	タク	トウ
商	アキ	アキナ	ショウ
啇	セキ	チャク	テキ	ネモト	モト	ヤワ
啉	カマビス	ムサボ	ラン
啊	ア	コエ
啌	クウ	コウ
啍	イキ	キョウ	コウ	シュン	タイ	テ	トン
問	ト/トイ/ド	トイ/ドイ	トン/ドン	ハル	モン
啐	オドロ	カチ	カツ	サ	サイ	サケ	シカ	シュチ	シュツ	セ	ヨ
啑	ショウ	ソウ
啓	アキ	アキラ	ケイ	サト	サトシ	サトル	タカシ	ハジメ	ヒラ/ヒラク	ヒロ	ヒロシ	ヒロム	ヨシ
啖	ク	クラワ	タン
啗	ク	タン
啘	エツ	エン	セツ
啚	オ	ト	ヒ
啛	サイ	セ	ナ
啜	スス	ススリ	セツ	テツ
啝	ワ
啞	ア	オシ
啠	アキ	アキラ	サト	サトイ	サトシ	サトル	サバ	シ	テツ	ノリ	ヨシ
啡	イビキ	ツバ	ハイ	ヒ	ヘ
啣	カン	クツワ	クワ
啤	ヒ
啦	ロウ
啻	シ	タダ
啼	テイ	ナ/ナキ
啾	シュウ	ナ
啿	タン	ドン	ユタカ
喀	カク/カッ	ハ
喁	アギトウ	キョウ	グ	ゴウ
喂	イ	カイ	キ	ナゲ
喃	ナン	ノ
善	イ	ゼン	タル	ヨ	ヨシ
喆	テツ
喇	ラ	ラツ
喈	カイ
喉	コウ	ノド
喊	カン	サケ	ヤク
喋	シャベ	チョウ	ツイバ	トウ
喎	カ	カイ	クウ	クチガユガ	ケ	ユガ	ヨコシマ
喏	シャ	ジャク	ダク	ニャ	ニャク	ハイ
喑	アン	イン	オシ	オン	サケ
喒	サン	ワレ
喓	コエ	ヨウ
喔	アク	オク	ラク
喗	ギン	グン	ゴン
喘	アエ	セキ	セン/ゼン
喙	カイ/ガイ	クチバシ
喚	カン	ヨ	ワメ
喜	アキ	キ/ギ	キュ	ノブ	ユキ	ヨシ	ヨロコ
喝	カツ/カッ
喞	カコ	ショク	ソク
喟	カイ	キ	ナゲ
喣	アラワシシ	イロ	ク
喤	オウ	キョウ	コウ	ナキゴエ
喧	カマビス	ケン/ゲン	ヤカマ
喨	リョウ	ロウ
喩	サト	タト	ユ
喪	ウシナ	ソウ	モ	モウ
喫	キツ/キッ	ノ
喬	キョウ	タカ	タカシ
喭	ガン	ゲン	トムラ	トリミダ
單	タン	ヒトエ
喰	ク/クイ	クイ/グイ	ジキ
喲	ヤク
営	イトナ	エイ
喿	カシマ	サワ	ショウ	スキ	ソウ
嗁	ダイ	テイ	ナ
嗃	キビ	キョウ	コウ	コエ	セ
嗄	カ	サ	シャガ	シワガ
嗅	カ/カギ	キュウ
嗆	ショウ	ソウ	ツ	ツイバ	ムセ
嗇	オシ	ショク	ヤブサ
嗉	ソ
嗋	オド	キョウ	コウ
嗌	アイ	アク	エイ	エキ	ノド	ヤク
嗎	ノノシ	バ
嗑	ア	オシャベリ	カタ	コウ	ノ
嗒	トウ	ナ
嗓	ソウ	ノド
嗔	イカ	シン
嗗	アツ	エチ
嗘	ケイ	コエ
嗚	アア	ウ	オ
嗛	ウラ	カン	キョウ	ケン	フク	ヘリクダ
嗜	コノ	シ	タシナ/ダシナ
嗞	シ	ナゲ	ワラ
嗟	ア	アア	サ	シャ	ナゲ
嗢	アツ	エチ	オツ	ノ	ムセブ	ラチ	ラツ
嗣	アキ	シ/ジ	ツ	ツカサ	ツギ	ツグ	ヒデ
嗤	シ	ワラ
嗩	サ
嗶	ヒチ	ヒツ
嗷	カマビス	ゴウ
嗹	オシャベリ	レン
嗽	ウガイ	クチスス	シュウ	スス	ソウ	ソク	ユス
嗾	ケシカ	ソウ	ソク/ゾク	ソソノカ
嗿	コエ	タン	トン
嘅	カイ	ナゲ
嘆	タン	ナゲ
嘈	カマビス	ショウ	ソウ
嘉	カ/ガ	カズ	ヒロ	ヨ	ヨイ	ヨシ	ヨシミ	ヨミ
嘊	イガ	ガイ
嘍	ウルサ	ミダ	ル	ロウ
嘎	カツ	ケチ
嘏	カ	ケ	サイワ
嘐	コウ	ヒョウ	ビュウ	ホウ	ミョウ	ロウロウ
嘑	ク	コ	サケ	ナ	ヨ
嘒	ケ	ケイ
嘔	ウタ	オウ	ク	ハ	ムカツ
嘖	サイナ	サク	サケ
嘗	カツ	ココロ	ショウ/ジョウ	ナ/ナメ
嘘	ウソ	キョ	コ	フ
嘙	ハ
嘛	マ
嘩	カ	カマビス	ケ
嘬	カ	サイ	セ	セイ	ムサボ
嘯	ウソブ	シツ	ショウ
嘰	キ	ケ
嘱	ショク	タノ
嘲	アザケ	チョウ	トウ
嘳	アワ	カイ	キ	ケ	ソシ	タメイキ
嘴	クチバシ	シ	ハシ
嘵	オソ	キョウ
嘶	イナナ	イバ	セイ
嘷	コウ	サケ	ホ
嘸	サゾ	サゾカシ	サゾヤ	ブ	ム
嘹	リョウ
嘻	アア	イ	イマシ	キ	ヤワラ	ワラ
嘼	キュウ	ク	チュウ	ヤシナ
嘽	アエ	オオ	サカン	セン	タ	タン	ヨロコ
嘿	アザム	コク	シズ	ダマ	ボク	モク
噀	ソン
噁	アク	ウ	オ	オコ
噂	ウワサ	ソン
噃	コエ	ハン	ボン
噄	キツ
噆	カ	サン	ソウ	フク
噉	ク	タン
噋	カク	タタ	トン
噌	カマビス	ショウ	ソ	ソウ
噍	カ	ザク	シャク	シュ	シュウ	ショウ
噎	イツ	エツ	ム	ムセ
噏	キュウ	ス
噐	ウツワ	キ
噔	トウ
噛	カ/カミ/ガ	コウ/ゴウ
噞	アギトウ	ゲン	ハゲ
噠	タチ	タツ
噡	ウルサクシャベ	ウワゴト	セン	タワゴト	タン	トウ
噢	イク	ウ	ウメ	ク	ユウ
噣	クチバシ	ショク	ソク	チュ	チュウ	ツ	ツイバ	トウ
噤	キン	ツグ
噦	アカ	エチ	エツ	オチ	カイ	キ	ケ	ケイ	シャックリ
器	ウツワ	キ/ギ
噩	オゴソ	オドロ	カク/ガク
噪	サワ	ソウ
噫	アア	アイ	イ	オク	オクビ
噬	カ	ゼイ
噭	キャク	キョウ	ケキ	サケ	ナ	ホ	ヨ
噯	アイ	イキ	ガイ
噱	ガク	キャク
噲	アカ	エ	カイ	カチ	カツ	ケ	ココロヨ	スス	ノド	ワイ
噴	ハ	フ/フキ	フキ/ブキ	フン
噵	トウ	ミチ
噸	トン
噺	ハナシ/バナシ
嚀	ニョウ	ネイ
嚄	アア	カク	ワク	ワメ
嚅	ジュ	ニュ	ヤカマ
嚆	コウ	サケ
嚇	オド	オドカ	カク
嚈	エン	ヨウ
嚊	カカア	カカウ	カカメ	ハナイキ	ヒ
嚋	タ	チュ	チュウ	ノロ
嚌	カイ	サイ	セイ	ナ
嚏	クサミ	クサメ	クシャミ	テイ	ハナ	ヒ
嚔	クサミ	クサメ	クシャミ	テイ	ハナ	ヒ
嚕	カタ	ヘツラ	ロ
嚙	カ	コウ/ゴウ
嚚	オロ	ガン	ギン	ゲン	ゴン	ツ	ワル
嚝	カク	コウ	サケ
嚞	テツ
嚟	リ
嚠	リュウ	ル
嚢	ドウ	ノウ	フクロ/ブクロ
嚥	エン	ノ
嚦	リャク	レキ
嚧	ロ
嚨	ノド	ル	ロウ
嚩	ノロ	ハク	バ
嚫	シン	ホドコ
嚬	ヒソ	ヒン
嚭	オオ	ヒ
嚮	キョウ	コウ	サキニ	ムカ
嚱	アア	キ	コエ
嚳	コク	ツ
嚴	イカ	イツクシ	オゴソ	キビ	ゲン	ゴン
嚶	オウ	ナ
嚷	ジョウ	ドナ	ワメ
嚼	カ	シャク
嚾	カマビス	カン	タン	ヨ	ワメ
囀	サエズ	テン
囁	ササ	ササヤ	ショウ
囂	カシマ	カマビス	キョウ	ゴウ
囃	サツ	ソウ	ハヤ/バヤ	ハヤシ
囅	テチ	テツ	テン
囈	ゲイ
囉	コエ	ラ
囊	ドウ	ノウ	フクロ
囋	コエ	サツ	サン	ザチ
囌	ソ	ヨクシャベ
囎	ショウ	ソ
囏	カタ	カン	ケン	ナヤ	モ
囐	ガチ	ガツ	コエ	サツ	ザチ	タダ
囑	ショク	タノ
囓	カ	カジ	ケツ/ゲツ
囗	イ	クニガマエ	コク
囘	エ	カ	カイ	マワ	モトオ
囙	イン	チナ	ヨ
囚	シュウ	トラ
四	ア	シ	ツ	ヨ	ヨツ/ヨッ	ヨン
囜	カシコ	ジン	ニン
囝	ガチ	ケン	コドモ
回	エ	カ	カイ	マワ/マワシ/マワリ	メグ/メグリ	モトオ
囟	シ	シン	ヒヨメキ
因	イン	チナ	テ	トラ	ヨ/ヨリ
囡	ジュウ	ナン	ノウ
団	カタマリ	ダン	トン/ドン	マル
囤	ザル	トン
囥	クラ	コウ
囦	エン	カク	カタ	コウ	ハナワ	フチ
囧	アキラカ	キョウ	ケイ	ソウ
囨	ヘン
囫	コチ	コツ	ハッキリシナイ	マッタシ
园	エン	ガン	タン	バン
囮	オトリ	カ	ユウ
困	コウ	コマ	コン
囱	ケムダシ	ス	ソウ	テンマド	マド
囲	イ	カコ/ガコ
図	エ	ズ	ヅ	ト	ハカ
囶	クニ	コク
囷	キン	クラ	コン
囹	レイ
固	カタ/ガタ	コ/ゴ
国	クナ	クニ/グニ	コ/ゴ	コク/コッ/ゴク
囿	ソノ	ユウ
圀	クニ	コク/ゴク	コツ
圁	ガン	ギン	ゲン	ゴン
圂	カワヤ	カン	コン	ダン	ワズラ
圃	ニワ	ハタ	ハタケ/バタケ	フ	ホ/ボ/ポ
圄	ギョ	ゴ	ヒトヤ
圇	リン
圈	カコ	ケン
圉	ウマカ	ギョ	ゴ	ヒトヤ
圊	カワヤ	ショウ	セイ
國	クニ/グニ	コ	コク
圌	カゴ	スイ	セン	マル
圍	イ	カコ
圏	カコ	ケン
圑	ニワ	ハタケ	フ	ホ
園	エン	オン	ソノ/ゾノ
圓	エン	ツブラ	マド	マドカ	マル	マロ
圕	ショ	トショカン
圖	エ	ズ	ト	ハカ
團	カタマリ	ダン	トン	マル
圚	エ	カイ	モン
圛	エキ	メグリユ	ヤク
圜	エン	カン	マル	メグ
圝	オウチ	ヒジキ	マドカ	マル	ラン
土	ツ	ツク	ツチ/ヅチ	ト/ド	ハ	ハニ	ヒジ
圠	アツ	エチ	カス
圢	タイ	チョウ	テイ	テン
圣	クツ	コチ	コツ	セイ	タガヤ
圤	ツチクレ	ハク	ホク
圥	キノコ	ロク
圦	イリ
圧	アツ/アッ	エン	オ	オウ	オサ	ヘ
在	ア/アラ	アリ	ザイ	マシマ
圩	イ	ウ	オ	キシ	キョ	クボ	ツツ
圪	イツ	オチ	ギチ	ギツ	ゴチ
圬	ウ	オ	コ	コテ	ヌ
圭	カ	カド	キヨ	キヨシ	ケ	ケイ	タマ	ヨシ
圮	クツガ	ヒ	ヤブ
圯	イ	シ
地	ジ	チ	ドマ
圳	シュ	シュン	ショウ	シン	ソン	ミゾ
圴	アト	サク	シャク	ショウ
圷	アクツ
圸	ママ
圻	キ	ギン	サカ
圽	ウ	ボツ	モチ
圾	アヤ	ギュウ	ゴウ	ショク	セイ
圿	アカ	カツ	ケチ	チリ
址	アト	シ
坂	カ	カサカ	サカ	ザ	ザカ	ハン/バン
坅	アナ	キン	コン	サン
坆	ハカ	バイ	フン
均	キン	ナラ/ナラシ	ヒト	ヒトシ
坊	ボ	ボウ	ボッ
坌	アツ	チリ	ナラ	フン	ホン	ワク
坍	タン	トン
坎	アナ	カン
坏	オカ	ツキ	ハイ
坐	オワス	サ/ザ	スワ/スワリ/ズワ	ソゾロニ	マシマス
坑	アナ	コウ
坒	キザハシ	ヒ
坡	ツツ	ハ/バ	ヒ
坢	タイ	チリ	ハン
坤	コン	ツチ	ヒツジサル
坥	ショ	ツツ
坦	タイラ	タン/ダン	ヒロシ	ヤス
坧	シャク	セキ	ドダイ
坨	イ	ケワ	ジ	タ	チ	ナナ
坩	カン	ツボ
坪	ツボ	ヘイ
坫	サカイ	チン	テン
坭	デ	デイ	ドロ	ナイ	ニ
坮	ウテナ	タイ	ツカサ	ワレ
坯	オカ	ハイ	ヒ	ヘ
坰	キョウ	ケイ
坱	オウ	チリ
坳	オウ	クボ
坴	リク	ロク
坵	オカ	キュウ
坷	カ
坹	ケツ	ゲチ
坺	ハチ	ハツ	ボチ
坻	サカ	シ	タイ	チ	テイ	ト	ナギサ	ニワ
坼	サ	サケメ	タク	チャク	ヒラ	ワカ
坾	ジョ	チョ
坿	フ
垁	ジ	チ
垂	シダ	シデ	スイ	タ/タラ/タレ/ダ	タル/ダル	ダレ	ナンナ	ナンナント
垃	ラツ
垈	タイ/ダイ	ヌタ
垉	ホウ
型	カタ/ガタ	ケイ
垌	ツ	ツボ	トウ
垓	カイ/ガイ	ハテ
垔	シュ	ショウ	ズ	トウ	フサ
垕	アカ	アツ	コウ
垗	チョウ	トウ	ハフリドコロ
垙	クウ	コウ	チマタ
垚	ギョウ
垜	ダ	ツミカサ
垝	キ	ダイ	ヤブ
垞	タ
垟	ヨウ
垠	キシ	ギン	ゴン	サカ
垡	タガヤ	ハツ	ボチ
垢	アカ	ク	コウ	ハジ
垣	エン	カイ	カキ/ガキ	ガイ
垤	アリヅカ	テツ
垧	キョウ	ケイ
垨	カミ	シュ	ス	マモ	モリ
垩	ショウ	セイ	ヒジリ
垪	ハ
垬	キョウ	コウ	ヌ
垰	アクツ	タオ	タワ	トウゲ
垳	イケ	イゲ	ガケ
垸	カン	マロ
垽	オリ	ギン	ゴン	メグ
埀	スイ	タ	ナンナント
埃	アイ	チリ	ホコリ/ボコリ
埆	カク	キソ
埇	オキツチ	ユ	ヨウ
埈	カイ	シュン	ソバダ
埋	イ	ウ/ウメ	ウズ	ウマ	ウモ	マイ
埌	ツカ	ロウ
城	イク	ガキ	キ/ギ	クニ	グシク	グスク	シキ	シロ/ジロ	ジョウ	スク	ゼイ	タチ	ナリ
埏	エン	コ	セン	ノボ	ハカミチ	ヤワラ
埒	カコ	ラチ	ラツ	レツ
埓	カコ	ラチ	ラツ	レツ
埔	ホ/ポ
埕	テイ	ビン
埖	ゴミ
埜	ショ	ノ	ヤ
埝	オ	シタ	テン	ドウ	ニョウ	ネン	マス
埞	ツツ	テイ
域	イキ
埠	ツカ	ハトバ	フ	ホ
埡	ウ	オ	サト
埣	ソツ
埤	アタエ	タス	ヒ	ヒクイヒメガキ	ヘイ	マス
埦	コバチ	ワン
埧	ク	ツツ
埩	ショウ	ソウ	タガヤ
埭	セキ	タイ
埰	サイ	ツカ
埴	ショク	ハニ	ヘナ
埵	タ
埶	イキホイ	ウ	ゲイ	セイ	ワザ
執	シ	シツ/シッ	シュウ	ト/トリ
埸	アゼ	エキ	サカイ	ヤク
培	ツチカ	バイ
基	キ	キイ	トモ	ハジメ	モト/モトヅ	モトイ
埼	キ	サイ	サキ	ミサキ
埽	シュ	ソウ	ハ
埾	キョ	シュ
埿	コテ	デイ	ナイ	ヌ	ハン
堀	クツ	ホッ	ホリ/ボリ/ポリ
堂	ドウ
堃	コン	ツチ	ヒツジサル
堄	ゲイ	ゲン	ヒメガキ
堅	カタ/ガタ	キン	ケン/ゲン
堆	ウズタカ	タイ	ツイ
堈	オカ	カメ	コウ
堉	イク
堊	ア	アク	イロツチ	オ	シロツチ
堋	ホウ
堌	ク	コ	ツカ	ツツ
堍	ト
堕	オ	クズ	ダ
堙	イン	フサ
堛	キョク	ツチクレ	ヒキ	ヒョク
堝	カ	ルツボ
堞	チュウ	チョウ	ヒメガキ
堟	ウネ	テン
堠	ク	コウ	モノミ
堡	トリデ	ホ	ホウ
堤	ツツミ/ツヅミ/ヅツミ	テイ
堦	カイ
堧	スナツチ	ゼン	ダ	ダン	ナ	ナン	ネン
堪	カン	コタ	コラ	タ/タエ	タマ	タン
堭	オウ	コウ	ソトボリ
堯	ギョウ	タカ
堰	エン	セ	セキ/セギ/ゼキ
報	シラ	ホウ/ポウ	ムク
堲	シ	シキ	シチ	シツ	ショク	ニク	フサ	モエサシ	ヤキツチ
場	ジョウ	チョウ	バ
堵	カキ	ト/ド
堹	アゼ	クロ	シュ	ショウ	チョウ	ツツ
堺	カイ	サカイ	サカエ
堽	コウ
堿	カン	コン
塀	ヘイ/ベイ
塁	スイ	トリデ	ライ	ル	ルイ
塉	シャク	セキ	ヤセツチ
塊	カイ	カタマリ	ケ	ツチクレ
塋	エイ	ハカ
塌	トウ
塍	アゼ	クロ	ショウ	ツツ
塏	カイ
塐	ソ	デク
塑	ソ	デク
塒	シ/ジ	トグロ	トヤ/ドヤ	ネグラ
塔	アララギ	トウ/ドウ
塕	オ	オウ	チリ
塗	ト	ヌ/ヌリ/ヌル	マミ	マミレ
塘	ツツミ	トウ	トモ/ドモ
塙	カク	カタ	コウ	ハナ/バナ	ハナワ/バナワ
塚	ズカ	チョウ	ツ	ツカ/ヅカ
塞	サイ	セ	ソク	トリデ	フサ	フサガ	ミ
塟	ソウ	ホウム
塡	ウズ	チン	テン	ハ	ハマ	フサ
塢	ウ	オ
塤	クン	ケン	ツチブエ	ハチ	ワン
塧	アイ	エ	ケワ
塨	キョウ
塩	アン	エン	シオ/ジオ	ショ
填	ウズ	シズ	チン	テン	ハ/ハマ	フサ	マキ
塰	アマ
塲	ジョウ	チョウ	バ
塵	ゴミ	ジン	チリ	チン
塸	オ	オウ	ハカ
塹	アナ	ザン	セン	ホリ
塼	カワラ	セン	タン
塾	ジュク
塿	ツカ	ツチ	ル	ロウ
墀	ジ	ス	チ
墁	コテ	バン	マン
境	キョウ	ケイ	サカ	サカイ/ザカイ	サカエ/ザカエ	ジキ
墅	シモヤシキ	ショ	ヤ
墇	ショウ	フセ
墈	カン	コン	サカイ
墉	カキ	カベ	ユ	ヨウ
墊	オチ	オボ	チョウ	テン	ナヤ
墌	シャク	セキ	ドダイ
墍	イコ	カイ	カザ	キ	ケ	ト	ヌ
墏	ショウ	ソウ	モト
墐	キン	ゴン	ヌ	ネバツチ
墓	ハカ/バカ	ボ
墔	サイ	ゼ
墖	トウ
増	ゾウ	フ	マ/マサ	マシ	マス
墜	オ	ツイ
墝	キョウ/ギョウ	コウ
墟	アト	キョ
墠	セン	タン
墡	シロツチ	セン
墢	ハイ	ハツ
墦	ツカ	ハン	ホン
墨	スノ	スミ/ズミ	ボク/ボッ
墩	トン
墫	シュン
墮	オチ	クズ	ダ
墱	キダ	トウ
墲	ブ	ボ	ム	モ
墳	フン/プン
墸	チョ
墹	ママ
墺	イク	オウ	キシ
墻	カキ/ガキ	ショウ
墼	キャク	ゲキ
墾	コン
壁	カベ	ヘキ/ベキ/ペキ
壂	オリ	カ	タチ	テン	トノ	ヤカタ
壄	ショ	ノ	ヤ
壅	フサ	ヨウ
壇	タン/ダン
壈	オン	ラン
壊	エ	カイ	コワ	ヤブ
壌	ジョウ	ツチ
壍	アナ	ザン	セン	ホリ
壎	クン	ケン	ツチブエ	ハチ	ワン
壐	ジ
壑	カク/ガク	タニ
壒	アイ	カイ	ツチケムリ
壓	アツ	エン	オ	オウ	オサ	ヘ
壔	オカ	ツカ	ツツ	トウ	トリデ
壕	コウ/ゴウ	ホリ
壖	アキチ	ゼン	ネン
壗	ママ
壘	スイ	トリデ	ライ	ルイ
壙	アナ	コウ
壚	イロリ	リョ	ロ
壜	タン	ドン	ビン
壝	イ	タ	ダン	ラチ
壞	エ	カイ	コワ	ヤブ
壟	ウネ	オカ	ツカ	リョウ	ロウ
壡	アキ	エイ
壢	アナ	リャク	レキ
壤	ジョウ	ツチ
壥	テン
壩	セキ	ハ	ヘ
士	オ	サムライ	シ/ジ	マ
壬	イ	ジン	ニン	ミズノエ
壮	サカン	ソウ	タケシ	ツヨシ
壯	サカン	ソウ	タケシ	ツヨシ
声	コエ/コエガ/ゴエ	コワ	ショウ/ジョウ	セイ
壱	イ	イチ	イツ/イッ	カズ	ヒト	ヒトツ
売	ウ/ウレ	ウリ	ウル	バイ	メ
壳	カク	カラ	コク	バイ
壷	コ	ツボ
壹	イ	イチ	イツ	ヒトツ
壺	コ	ツボ
壻	セイ	ムコ
壼	コン
壽	カズ	コトブ	コトブキ	コトホ	シュウ	ジ	ジュ	ス	トシ	ヒサ	ヒサシ
夂	シュウ	チ	フユガシラ
夅	オ	クダ	コウ	ゴ	フ
夆	ア	アツ	サカ	バ	ヒ	フ	ホウ
変	カ/カワ/ガ	ガワ	ヘン/ペン
夊	スイ	スイニョウ	ユキ
夋	ウズクマ	シュン
夌	シノ	スタ	リョウ
夏	カ/ガ	ゲ	ナツ
夐	ケイ	ケン	ハルカ
夒	ドウ	ノウ	メザ
夓	カ	ゲ	ナツ
夔	キ
夕	セキ	ユ	ユウ	ユウベ
外	ウイ	ガイ	ケ/ゲ	ソ	ソデ	ソト/ソド	ト/ド	トノ	ハズ	フカ	ホカ
夘	ウ	タカキ	ボウ	モウ
夙	シュク	ツト	ツトニ	ハヤ	ハヤイ
多	オオ	タ/ダ	マサ
夛	オオ	タ	マサ
夜	ヤ	ヨ	ヨル
夝	ショウ	セイ	ソウ	ハ
夡	オオ	キ
夢	クラ	ボウ	ム	ユメ
夣	クラ	ボウ	ム	ユメ
夤	イ	イン	オオ	ツツシミオソ	ノ
夥	オビタダ	カ	ワ
大	ウフ	オ	オウ	オオ/オオキ	タ/ダ	タイ/ダイ	タカシ	トモ	ハジメ	ヒロ	ヒロシ	マサ	マサル	モト	ワ
夨	カタム	シキ	ショク	レチ	レツ
天	アキ	アマ	アマツ	アメ	アモ	ソラ	タ	タカシ	テ/デ	テッ	テン/デン	ナマ
太	オオ	タ/ダ	タイ/ダイ	タカ	ヒロ	フト/ブト	フトシ
夫	オ	オット	ソレ	ツマ/ヅマ	ト	フ/ブ/プ	フウ/プウ	ユウ	ヨ
夬	カイ	ケチ	ケツ	ワ
夭	オウ	カ	ヨウ	ワカ	ワカジニ	ワザワイ
央	アキラ	エ	オ	オウ	サト	チカ	テル	ナカ	ヒサ	ヒサシ	ヒロ	ヒロシ	ヤ
夯	カツ	コウ	ニナ
夰	コウ	ハナ
失	ウ/ウセ	ウシナ	シツ/シッ	ナ
夲	ホン	モト
夳	タイ
夵	エン	スス	トウ
夶	クラ	ヒ
夷	イ	エビス	エミシ	コロ	シ	タイ
夸	カ	コ	ホゴ
夾	キョウ	コウ	ハサ
夿	オオ	ハ	ヘ
奃	オオ	タイ	テイ
奄	アマ	エン	オオ	タチマチ
奆	オオ	ガン	ケン
奇	アヤ	キ/ギ	ク	クシ	メズラ
奈	イカン	カラナシ	ダイ	ナ	ナイ
奉	ササ	タテマツ	トモ	ブ	ホウ/ボウ/ポウ	マツ	ヤス
奎	キ	ケイ
奏	カナ/カナデ	ススム	ソウ
奐	アキ	カン
契	ケイ	チギ	チギリ
奒	ガイ	タテマツ	ブ	ホウ	マツ
奓	ア	オゴ	シ	シャ	タ	ハ
奔	ハシ	ホン/ポン
奕	エキ	ヤク
套	カサ	トウ
奘	サカン	ジョウ	ソウ
奙	ホン
奚	ケイ	ナンゾ
奛	アキ	コウ
奝	オオ	タカ	チョウ
奞	シュン	スイ	ハ	ヨウ
奟	コウ	ヒョウ	ホウ
奠	サダ	テイ	テン/デン	マツ
奡	アナド	ゴウ	ツヨ
奢	オゴ	シャ/ジャ
奣	アキ	オウ	コウ	ワン
奥	オ	オウ	オオ	オキ	オク	オン	クマ	ツ	ノク
奧	オウ	オク	クマ
奨	ショウ	スス	ススム	ソウ	マサシ
奩	クシゲ	ハコ	レン
奪	ウバ	ダツ/ダッ
奫	イズミ	イン
奬	ショウ	スス	ススム	ソウ
奭	イカ	カク	キャク	サカン	シャク	セキ
奮	フル	フルイ	フン/プン
奯	オオ	カチ	カツ	ヒロビロト
奲	オオ	シャ	セン	タ	ユル
女	オナ	オンナ	ジョ	タ	ツキ	ナ	ニョ	ニョウ	ネ	メ
奴	ド	ヌ	ヤッコ	ヤツ
奵	チョウ	テイ	テン
奶	ダイ	チチ	ナイ	ネ	ハグク
奸	オカ	カン
她	アザ	イ	シャ	ジ	タ	チ
奻	イイアラソ	ダン	ナン
奼	オトメ	タ	ツ	ト	ホコ
好	イ	コ	コウ/ゴウ	コノ	コノミ	コノム	ゴノ	ス/ズ	タカ	トシ	ヨ	ヨシ	ヨシミ
妁	シャク	ナコウド
如	イ	キ	ゴト	シ	ジョ	ニョ	ネ	ユキ	ヨシ
妃	キ	キサキ	ヒ/ビ/ピ	ミ
妄	ボウ	ミダ	モウ
妊	ジン	ニン	ハラ	ミゴモ
妋	ウ	セ	セウト	ナセ	フ	ミョウト	ムサボ	ユウ	ヨウ
妌	イサギヨ	シズ	ジョウ	セイ
妍	ウツク	ケン
妎	オオ	カイ	キ	ケイ	ネタ	ワズラ
妒	ソネ	ツ	ツモ	ト	ネタ	フサ
妓	ウタイメ	キ/ギ	コ	ワザオギ
妕	アザナ	チュ	チュウ
妖	アヤ	ナマ	ヨウ	ワザワ
妗	ウツク	カン	キン	ケン	ゴン	セン	ヨロコ
妙	タエ	ビョウ	ミョウ
妛	アナド	オロカ	シ	ミダル	ミニク
妝	ショウ	ソウ	ヨソオ
妟	アン	エン	ヤス
妣	ナキハハ	ヒ
妤	ヨ
妥	ダ	ヤス
妧	ガン	ゲン	ミメヨ
妨	サマタ	ボウ
妬	ソネ	ツ	ツモ	ト	ネタ	フサ	ヤ
妭	ツマ	ハツ	バチ	ミメヨ
妮	ジ	ニ	ハシタ	ヤワラカクマツハ
妯	アイヨ	イタ	ウゴ	サワ	ジク	チュウ	トク	ロク
妰	シズ	チャク
妲	ダツ
妳	アネ	ジ	ダイ	デイ	ナイ	ニ	ネ	ハグク	ハハ
妷	イチ	イツ	オイ	ジチ	チツ	テツ	メイ
妹	イモウト	イモト	ス	セ	マイ	モ
妺	アザナ	バイ	バツ	マチ	マツ
妻	サイ	ズマ	ツマ/ヅマ	メ	メアワ
妼	コシモト	ヒ	ヒツ	ビチ
妾	ショウ	ソバメ	メカケ	ワラワ
姁	ウツク	ク	タノ	ツマ	ハハ
姃	アザナ	ショウ	セイ
姄	ビン	ミン
姆	ウバ	ボ	モ
姈	アザナ	リョウ	レイ
姉	アネ	シ	ネエ	ハハ
姊	アネ	シ	ハハ
始	シ	ハジ	ハジメ	モト
姍	サチ	サツ	サン	セン	ソシ	ハン	ミニク	ミメヨ
姐	アネ	シャ	ソ	ネエ	ネエサン
姑	オバ	コ	シバラク	シュウト/ジュウト	シュウトメ/ジュウトメ
姒	アネ	シ
姓	ショウ/ジョウ	セイ
委	イ	クワ	マカ	マカセ	ユダ
姙	ジン	ニン	ハラ	ミゴモ
姚	ウツク	チョウ	ヨウ
姜	カン	ガ	キョウ	コウ
姝	ウツク	シュ	ス
姞	キチ	キツ	ツツシ
姟	ガイ
姣	イサギヨ	ウツク	キョウ	コウ	ミメヨ
姤	ア	ク	コウ	ミニク	ミメヨ
姥	ウバ	ボ	モ
姦	カシマ	カン	ケン	ミダラ
姧	カシマ	カン	ケン	ミダラ	ヨコシマ
姨	イ	イモウト	イモト	オバ	テイ
姪	イチ	イツ	オイ	ジチ	チツ	テツ	メイ
姫	キ	ヒメ
姮	コウ	ジョウ
姯	コウ	ミメヨ
姱	ウツク	オゴ	カ	ク	ケ	コ	ミメヨ
姲	アザナ	アン	エン
姴	ウツク	レチ	レツ
姶	アイ	オウ
姷	ウ	タグ	ナラ	ユウ
姻	イン
姿	シ	シナ	スガタ
娀	シュ	シュウ
威	イ	イサ	オド	タケ	タケシ	タケル
娃	ア	アイ	イ	ウツク	ワ
娄	ツナ	ヒ	ル	ロウ
娉	ヘイ	ホ	ホウ
娌	アニヨメ	リ
娍	ジョウ	スラリトシテミメヨ	セイ
娎	キョウ	ケチ	ケツ	ココチヨ	ヨロコ
娑	サ	シャ
娒	ウバ	ボ	モ
娓	ウツク	キ	シタガ	スナオ	ビ	ミ
娘	コ	ジョウ	ムスメ
娚	タワム	ドウ	ナン	ノウ	メオト
娜	ダ	ナ
娞	アデ	スイ	ダイ	ネ	ヤス
娟	エン	ケン
娠	シン
娣	イモウト	オバ	ダイ	テイ
娤	ショウ	ソウ	ヨソオ
娥	ガ	ミメヨ
娧	イト	エチ	エツ	タイ	テ	ミメヨ	ヨロコ
娨	カン	ゲン	ゴウマン	バン	マン
娩	ベン
娪	オンナ	ギョ	ゴ
娭	アイ	キ	タワム	ハシタ
娯	ゴ
娰	アネ	シ
娵	シュ	シュウ	ス	ソウ	ヨメ
娶	シュ	メアワ	メト
娼	アソビメ	ショウ
婀	ア	アダ	タオヤカ
婁	ツナ	ヒ	ル	ロ	ロウ
婄	オロ	バイ	ブ	ホウ	ミニク
婅	アザナ	キク	コク
婆	バ	バア	ババ
婇	ウネメ	サイ
婈	アザナ	リョウ
婉	ウツク	エン	シタガ
婌	シュク
婐	カ	タオヤ	ハベ	ワ
婕	ショウ	ミメヨ
婚	コン
婞	ギョウ	ケイ	コウ	マッスグ	モト
婢	ハシタメ	ヒ
婣	イン
婥	シャク	テキ	ドウ	ニョウ	ミメヨ
婦	ネ	フ/ブ/プ	ヨメ
婧	アテヤカ	シナヤ	ショウ	ジュウ	セイ
婪	ムサボ	ラン
婬	イン	ヒタ	ホシイママ	ミダ	ミダレ
婭	ア	アイムコ	コシモト
婷	ウツク	チョウ	テイ
婺	ブ	ボウ	ボク	ム	モク
婻	ウツク	ダン	ナン
婾	ゴマカ	ツ	トウ	ヌス	ユ	ワルガシコ
婿	セイ	ムコ
媋	ウツク	シュン
媐	イ	キ	タノ	ツマ
媒	ナカダチ	ナコウド	バイ
媓	オウ	コウ	ハハ
媖	エイ	ユウ
媙	イ	ウツク
媚	コ	コビ	ビ
媛	エン	ヒメ
媜	アザナ	チョウ	テイ
媞	シ	タ	タイ	ツマビ	テイ	ハハ	ワルガシコ
媟	アナド	ケガ	セチ	セツ	ナレ
媠	オコタ	タ	ナ	ミメヨ	ラ
媢	ニラ	ネタ	バイ	ボウ	ボク	メ	モウ	モク
媧	カ	カイ	ケ
媬	ホ
媱	タワム	ミメヨ	ヨウ
媲	ツレアイ	ヒ	ヘイ
媳	シャク	セキ	ヨメ
媵	オク	オクリビト	オクリメ	ツキソ	ヨウ
媸	アナド	オロ	シ	ミダ	ミニク
媺	ウツク	ビ	ミ	ヨイ
媻	オゴ	ハ	ハン	メカケ	ヨロメ
媼	オウ	オウナ
媽	ハハ	ボ	モ
媾	コウ	ヨシミ
媿	キ	トガ	ハジ	ハズカシ
嫁	イ	カ	トツ	ユ	ヨメ
嫂	アニヨメ	ソウ
嫄	ガン	ゲン
嫆	アザナ	ユ	ヨウ
嫈	エイ	オウ	ギョウ	ケイ	ショウ	ミニク	ミメヨ
嫉	シツ/シッ	ソネ	ニク	ネタ
嫋	シナヤ	ジャク	ジョウ	タオ	デキ	ナヨ
嫌	イヤ	キラ	ギラ	ケン/ゲン
嫏	ロウ
嫐	ジョウ	ドウ	ナブ
嫖	カル	ヒョウ
嫗	アタタ	ウ	オウ	オウナ
嫚	アナド	エン	オコタ	オゴ	ケガ	バン	ベン	マン	メン
嫜	シウト	シウトメ	ショウ
嫠	ヤモメ	リ
嫡	チャク	テキ
嫣	エン
嫥	セン	タン	トトノ	モッパラ
嫦	コウ	ジョウ
嫩	ドン	ノン	ワカ
嫪	コイシタ	ナヤ	ロウ
嫮	オトメ	コ	ホコ	ミメヨ
嫵	コ	ブ	ミメヨ	ム
嫶	ショウ	ソウ	ヤセ	ヤツ
嫺	カン	ナラ	ミヤビヤカ
嫻	カン	ナラ	ミヤビヤカ
嫽	サトイ	タワム	ミダ	ミメヨ	リョウ	ロウ
嬀	キ	ワルガシコ
嬁	ウツク	トウ
嬈	キョウ	ジョウ	ドウ	ナヤ	ニョウ	ヨウ	ワズラ
嬉	ウラシ	ウレ	ウレシ	キ	タノ
嬋	セン
嬌	キョウ	ナマメカ
嬖	キニイリ	ヘイ
嬗	セン	タン	ユル
嬙	シキ	ショウ	ショク	ソバメ	ゾウ
嬛	カタ	ギョウ	ケイ	ケン
嬝	シナヤ	ジャク	ジョウ	タオ	デキ	ナヨ
嬡	アイ
嬢	ジョウ	ムスメ
嬥	アデ	ジョウ	タク	チャク	チョウ	テキ	トリカ	ヨイ
嬪	ヒメ	ヒン/ビン/ピン
嬬	ジュ	ツマ	ヨワ
嬭	アネ	ジ	ダイ	デイ	ナイ	ニ	ネ	ハグク	ハハ
嬰	アカゴ	エイ	フ	ミドリゴ
嬲	ジョウ	ドウ	ナブ
嬴	エイ
嬶	カカ	カカア
嬸	シン
嬾	オコタ	モノウイ	ラン
孀	ソウ	ヤモメ
孁	オンナノアザナ	メ	リョウ	レイ
孃	ジョウ	ムスメ
孅	カヨワ	セン
孋	アザナ	マタ	ライ	リ	レイ
孌	シタウ	スナオ	バン	マン	ミメヨ	ラン	レン
子	イ	キ/ギ	ク	ケ	コ/ゴ	シ/ジ	ス/ズ	ツ/ヅ	ネ	ネッ
孑	ケツ	ヒトリ
孒	カチ	キョウ	ク	クツ	ケツ	ヒダリノウデガナイ	ミジカ
孔	アナ	ク	コウ	ノリ
孕	ハラ/バラ	ハラミ	モト	ヨウ
孖	シ	フタゴ
字	アザ	アザナ	ジ	ナ
存	ア	アリ	ソン/ゾン	タモ	ト	ナガラ	マサ
孚	タマゴ	ハグク	フ	マコト
孛	ハイ	ブツ	ボツ
孜	シ	ツト	ツトム
孝	キョウ	コウ	タカ	タカシ	ノリ	ヨシ
孞	シン
孟	オサ	カシラ	タケ	タケシ	ツトム	ハイ	ハジメ	ハル	ボウ	ミョウ	モウ
季	キ	スエ	トシ
孤	コ
孥	ツマコ	ド	ヌ
学	ガク/ガッ	サトル	タカ	ノリ	マナ	マナビ	マナブ
孨	ジュウ	セン	ツツシ	ニュウ	ミナシゴ	ヨワ
孩	カイ/ガイ	チノミゴ
孫	ソン	ヒ/ビ	マゴ
孮	ズ	ソウ
孯	カタ	カン	ケン
孰	イズレ	ジュク	タレ
孱	サン	セン	ヨワ
孳	ウ	シ/ジ	シゲ
孵	カエ	フ
學	ガク	サトル	マナ/マナブ
孺	オサナイ	ジュ	チノミゴ
孼	ゲチ	ゲツ	ヒコバエ	ワキバラ	ワザワ
孽	ゲチ	ゲツ	ヒコバエ	ワキバラ	ワザワ
孾	エイ	ミドリゴ
孿	サン	セン	フタゴ	レン
宀	ウカンムリ	ベン	メン
宁	エイ	タクワ	タタズ	チョ	チヨウ
它	タ	ヘビ
宄	キ	ミダレ	ヨコシマ
宅	ケ	タカ	タク/タッ	タケ	ヤ	ヤケ
宆	アメ	キュウ	キョウ	ソラ
宇	イエ	ウ	タカ	ヒロ	ヒロシ
守	ウ	カミ	シ	シュ/ジュ	ス	テ	マモ	マモリ	マモル	モ	モリ
安	ア	アス	アズ	アッ	アン	イズク	ヤ	ヤス	ヤスシ
宊	カ	ツ	トツ
宋	ソウ
完	カン	タモツ
宍	シ	シシ	シン	ジク	ニク
宎	ヨウ
宏	アツ	コウ	ヒロ	ヒロシ	ヒロム
宐	ギ	ムベ	ヨロ
宑	ウチイド	ショウ	セイ
宓	ヒツ	フク	ミチ	ヤス
宔	シュ
宕	スギル	トウ
宖	コウ	ヤス
宗	カズ	シ	シュウ/ジュウ	ソ	ソウ	ソオ	タカ	タカシ	トシ	ノリ	ハジメ	ヒロ	ムナ	ムネ	モト	ヨシ
官	カン/ガン	ツカサ
宙	チュウ	ヒロ	ユ
定	サタ	サダ/サダメ	サダム	ジョウ	テイ
宛	ア	アタカ	アテ	エン	サナガ	ヅツ
宜	キ/ギ	タカ	ノブ	ノリ	ムベ	ヨシ	ヨロ
宝	タカラ/ダカラ	ホ/ボ/ポ	ホウ/ボウ/ポウ
実	グミ	サネ/ザネ	シツ/ジツ	ジツ/ジッ	マコト	ミ	ミチ	ミノ/ミノル
客	カク/カッ	キャク/キャッ
宣	セン/ゼン	トオル	ノ	ノタマ	ノブ	ノボル	ノリ	ヒサ	ヨシ
室	シツ	ムロ
宥	ナダ	ユウ	ユル
宦	カン	ツカサ
宨	チョウ	テワ	ホシイママ
宩	シ
宬	クラ	ジョウ	セイ
宭	クン	ムレイ
宮	キュウ/ギュウ	ク/グ	クウ/グウ	ミ	ミヤ
宯	キガアガリムス	キョウ	コウ
宰	オサム	サイ/ザイ	タダ
宱	サ	ジャ	ヒロ
宲	シマイコ	ホウ
害	ガイ
宴	ウタ	ウタゲ	エン	ヤス
宵	ショウ	ヨイ
家	アリ	イエ	ウチ	エ	カ/ガ	ク	ケ/ゲ	ツカ	ベ	ヤ
宷	アキラ	サイ	サダカ	シン	ツブサ	ツマビ
宸	シン	ノキ
容	イ	イルル	カタ	ヒロ	ヒロシ	マサ	ヨウ
宺	コウ	ヒロ
宼	アダ	コウ
宿	シュク/シュッ/ジュク	スク	ブスキ	ヤケ	ヤド/ヤドリ
寀	サイ	チギョウショ	ツカサ
寁	サン	ショウ	スミ	トシ
寂	サ	サビ	サミ	ジャク/ジャッ	セキ
寃	エン
寄	キ/ギ	ヤドリキ	ヨ	ヨセ	ヨリ	ヨロ
寅	イン	トモ	トラ	ノブ
密	ヒソ	ヒソカ	ミツ/ミッ
寇	アダ	コウ
寉	ツル
富	ト	トミ/ドミ	トン	フ/ブ/プ	フウ	フッ
寍	ネイ	ムシ
寏	カン	グルリトメグラシタカキ
寐	ネ	ビ
寒	カン	サ	サム/ザム	サン
寓	カコツ	カリズマイ	グ	グウ	ドウ	ヨ
寔	コレ	ショク	ジキ	マコト	マコトニ
寖	シン	ソソ	ツ	ヒタ
寗	デイ	ニュウ	ニョウ	ネイ	ネガ
寘	イ	オク	シ	ト
寙	ウ	オコタ	ナマ	モノウ	ユ
寚	タカラ	ホウ
寛	カン	クツロ	トモ	ノブ	ノリ	ヒロ	ヒロシ	ヒロン	ユタ	ユタカ	ユル
寝	イ	シン	ネ/ネト	ミタマヤ	ヤ
寞	サビ	バク	マク
察	サツ/サッ
寠	ク	チイサ	マズ	ヤツ	ル	ロウ
寡	カ	ヤモメ
寢	イ	シン	ネ	ミタマヤ	ヤ
寤	ゴ	サ
寥	サビ	リョウ
實	サナ	サネ	シツ/ジツ	マコト	ミ	ミチ	ミツ	ミノ	ミノル
寧	アキ	ネイ	ムシ	ヤス	ヤスシ	ヨシ
寨	サイ	トリデ
審	アキラ	シン	ツブサ	ツマビ
寫	ウツ	シャ
寮	リョウ
寯	アツ	シュン	スグ
寰	カン
寱	オドロ	ゲイ	ネゴト
寳	タカラ	ホウ	ミ
寴	シタ	シン
寵	チョウ	メグ
寶	タカ	タカラ	ホウ
寸	ス	スン/ズン	ミキ
寺	ジ	テラ/デラ
寽	ツマ	ト	リチ	リツ	リン
対	アイテ	コタ	ソロ	タイ	ツイ/ツイシ	ツシ	ツレア	ナラ	ムカ
寿	カズ	コトブ	コトブキ	コトホ	シュウ/ジュウ	ジ	ジュ	ス/ズ	スッ	スミ	トシ	トシカツ	ナガ	ノブ	ノリ	ヒサ	ヒサシ	ヒトシ	ヤス
封	フウ/ブウ/プウ	ホウ/ポウ
専	セン	モッパ
射	イ	ウ	サ/ザ	シャ/ジャ
尅	カツ	コク
将	カツ	カツリ	ショウ/ジョウ	ススム	ソウ	タカ	ハタ	ヒキイ	マサ	マサル	モッテ	ユキ
將	ショウ	ソウ	ハタ	ヒキイ	マサ	マサル	モッテ
專	セン	モッパ
尉	イ	ジョウ
尊	サダ	ソン/ゾン	タカ	タカシ	タケ	タット	トウト	ミコト
尋	ジン	ズ	タズ	ツグ	ト	ヒロ/ピロ
尌	シモベ	シュ	ジュウ	タ	チュ	ワラワ
對	アイテ	コタ	ソロ	タイ	ツイ	ツシ	ツレア	ナラ	ムカ
導	シル	シルベ	ドウ	ミチ	ミチビ
小	イサラ	オ	コ/コジ/ゴ	コウ	サ	サザ	シャオ	ショウ	チ	チイ	チイサ	チッ
少	ショウ	スク/スクナ/ズク	スコ
尓	シカリ	ジ	ソノ	ナンジ	ニ	ノミ
尖	サキ	スルド	セン	ト	トガ
尗	シュク	マメ
尚	ショウ/ジョウ	タカ	タカシ	ナイシ	ナオ	ナリ	ヒサ	ヒサシ
尞	カガリビ	リョウ
尟	スクナ	セン
尠	スクナ	セウ	セン
尢	オウ	ダイノマゲアシ	モットモ
尣	オウ	マゲアシ
尤	トガ	モット	ユウ
尦	チョウ	ホウ	ユキナヤ	リョウ
尨	ボウ	ムク	ムクイヌ
尩	アシナエ	オウ	マ	ヨワ
尫	アシナエ	オウ	マ	ヨワ
尬	アシナエ	カイ	カツ	ケチ
尭	アキ	ギョウ	タカ	タカシ	ノリ
尮	アシナエ	セムシ	タ
尰	シュウ	ショウ	ジュ
就	シュウ	ジュ	タカ	ツ/ツク	ナリ
尲	カン	ケン
尵	ウマガヤ	タイ	デ
尶	カン	ケン
尸	カタシロ	シ	シカバネ	シカバネカンムリ
尹	イン	オサ	タダ	チカ
尺	シャク/シャッ/ジャク	セキ
尻	ガミ	コウ	シ	シリ/ジリ	チリ
尼	アマ	ニ
尽	コトゴト	サカヅキ	サン	ジン	ズ	ツ/ツク/ヅ	ツカ	ツキ	ツク/ツクシ	ヅク	ヅクシ
尾	オ	ビ
尿	イバリ	ニョウ	バリ	ユバリ
局	キョク	ツボネ
屁	オナラ	ヒ	ヘ/ペ
居	イ/イア	オ/オリ	オキ	キョ	グ	コ/ゴ	スエ/ズエ
屆	カイ	トド
屈	カガ	クグ	クツ/クッ	コゴ
届	カイ	トド/トドキ	トドケ
屋	オク	タ	ャ	ヤ
屍	カバネ	シ	シカバネ
屎	キ	クソ	シ
屏	オオ	シリゾ	ビョウ	ヘイ/ペイ
屐	ケキ/ゲキ	ハキモノ
屑	イサギヨ	クズ	セツ
屓	キ
展	テン	ノブ	ノリ	ヒロ	ユキ
屙	ア
屚	モ	ロ	ロウ
屜	クツシキ	シキワラ	タイ	テイ
属	サカン	サッカ	ショク	ゾク/ゾッ	ツキ	ツク	ヤカラ
屠	チョ	ト	ホフ
屡	シバシバ	ル
屢	シバシバ	ル
屣	シ	ゾウリ
層	ソウ
履	グツ	ハ/バ	ハキ/バキ	フ/フミ	リ
屧	クツシキ	シキワラ	ショウ	タイ	テイ
屨	ク	クツ
屩	イトグツ	カク	キク	キャク	キョウ	クツシキ	コク	シキワラ
屬	サカン	ショク	ゾク	ツク	ヤカラ
屭	キ	キビ	サカン
屮	サ	テツ	ヒダリテ	フルクサ
屯	タムロ	トン/ドン
屰	ギャク	ゲキ	サカ	ハク	ヒャク
山	サ	サン/ザン	セン/ゼン	ヤノ	ヤマ	ヤン
屴	ソビ	リキ	リョク
屵	アオゴ	ガチ	ガツ	キシガタカイ	ゲチ	ゲツ
屶	タナ	ナタ
屹	キツ/キッ	ソバダ
屺	キ
屻	ジン	ニン
屼	グチ	グツ	コツ	ゴチ
屽	カン
岇	ゴウ	ヤマノタカイ
岈	カ	コ	コダマ
岊	グ	セチ	セツ
岌	キュウ	タカ
岏	ガン	ケワ	タカ
岐	キ/ギ	タカシ	マタ
岑	ギン	シン	ミネ
岒	ケン/ゲン
岔	タ
岝	サク	シャク
岟	オウ	フモト	ヨウ
岠	キョ	ゴ
岡	オカ/オガ	コウ
岢	カ
岣	イタダ	ク	コウ
岦	リュウ	リョウ
岨	イシヤマ	ショ	ソ	ソバ	ソワ
岩	イワ	ガン
岪	フツ	ブチ	ヤマミチ
岫	クキ/グキ	コウ	シュウ	ミサキ	ミネ	ユウ
岬	コウ	サキ/ザキ	ミサキ
岱	タイ/ダイ
岲	キョウ	コウ
岳	オカ	ガク	タカ	タケ/ダケ/ダゲ	タケシ	タケン
岴	ク	ケワ
岵	コ	ヤマ
岶	ハク
岷	ビン	ミン
岸	ガン	キシ/ギシ	ケシ/ゲシ
岺	レイ
岻	シ/ジ	ニ
岼	ユリ
岾	ハケ	ヤマ
峅	クラ
峇	コウ/ゴウ
峉	ガク	ギャク
峋	シュン
峒	ズ	トウ
峗	ガイ	キ	グチ	グツ	ゲ
峙	ジ	ソバダ
峝	エビス	ズ	トウ
峠	タオ/ダオ	トウ	トウゲ
峡	カイ	キ	キョウ	コウ	ハザマ	バ
峨	ガ	ケワ
峩	ガ	ケワ
峪	タニ	ヨク
峭	キビ	ケワ	ショウ
峮	キン	クン	コン	ツラ
峯	ネ	ホウ/ボウ/ポウ	ミネ
峰	ツミネ	トウ	ネ	ブ	ホ	ホウ/ボウ/ポウ	ミネ
峱	ドウ	ノウ
峲	リ
峴	ケワ	ケン
島	シマ/ジマ	トウ/ドウ
峺	コ
峻	オカ	ケワ	シュン	タカ	タカシ	チカ	トシ
峽	カイ	キョウ	コウ	ハザマ
崁	カン	クボミ
崆	ク	コウ
崇	アガ	ス	スウ	タカ	タカシ	タカム
崋	カ	ク
崍	ライ
崎	キ	サイ	サキ	ザキ	マサキ	ミサキ
崑	コン
崒	ケワ	シュチ	シュツ	スイ	ソツ	ゾチ
崔	ガイ	ガケ	サイ	スイ	チェ
崕	ガイ	ガケ
崖	ガイ	ガケ	キシ	ギ	ゲ	ハテ
崗	オカ	コウ
崘	ロン
崙	ロン
崚	リョウ
崛	クツ	ソバダ	タカ
崟	ギン	ミネ
崢	ソウ
崣	イ
崤	ギョウ	コ	コウ
崦	エン
崧	シュ	シュウ	スウ	ソバダ
崩	クズ	クズレ	ホウ
崫	クツ	ソバダ
崱	ショク	ジキ
崴	イ	エ	ワイ
崹	ダイ	テイ
崽	コドモ	サイ	シ	シャ
崿	ガク	ガケ	キシ	ゴウ
嵂	ケワ	リチ	リツ
嵃	ガン	ケワ	ゲン
嵆	ケイ
嵈	カン
嵊	ショウ
嵋	ビ
嵌	アナ	カン/ガン	ハ/ハメ	ハマ
嵎	クマ	グ	グウ
嵐	アラシ	ゾレ	ラン
嵑	イシブミ	カチ	カツ	ケツ	ゲチ	ソビ
嵒	イワ	ガン	ケワ
嵕	ソウ
嵙	カ	ヤマシナ
嵜	キ	サイ	サキ	ミサキ
嵟	キ	タイ	タカ	テ
嵠	ケイ	タニ	タニガワ
嵡	オ	オウ
嵢	ソウ
嵤	エイ	ギョウ	ケイ	コウ	ヨウ
嵩	カサ/カサミ/ガサ	コウ	シュウ	スウ	タカ	タカシ	タケ/ダケ
嵪	カタ	キョウ	コウ	ヤセテカタイツチ
嵬	カイ	ギ
嵭	クズ	ヒョウ	ホウ
嵯	サ	シ
嵰	カン	ケン
嵳	サ
嵶	タオ	タワ
嵹	キョウ	ゴウ
嵺	キョウ	コウ	タカ	リョウ
嵾	サン	シン	ソン
嵿	チョウ	テイ
嶁	イタダ	ル	ロウ
嶂	ショウ	ミネ
嶃	ケワ	サン	セン
嶄	サン/ザン
嶇	ク	ケワ
嶈	ショウ	ソウ
嶊	サイ	スイ	セ	ツイ
嶋	シマ/ジマ	トウ
嶌	シマ/ジマ	トウ
嶐	ヤマノカタチ	リュ
嶒	ショウ	ゾウ
嶓	ハ
嶔	カン	キン	ケワ	ケン	コン
嶕	ショウ
嶙	リン
嶛	リョウ
嶝	サカミチ	トウ
嶟	シュン	ソバダ	ソン
嶠	キョウ
嶢	ギョウ	ケワ
嶧	エキ	シャク	セキ	ツラ	ヤク
嶫	ギョウ	タカ
嶬	ギ
嶮	ケワ	ケン
嶰	カイ	ケ	タニ
嶲	エ	キ	ケイ	スイ	ツバメ	メグリ
嶴	オウ	オク	クマ
嶷	ギ	ギョク	サト
嶸	エイ	オウ	ケワ	コウ	ヨウ
嶹	シマ	トウ
嶺	ネ	ミネ	リョウ	レイ
嶼	シマ	ショ
嶽	ガク	タキ	タケ/ダケ
巃	ケワ	ル	ロウ
巇	キ	ケワ
巉	サン/ザン
巋	キ	ツラ
巌	イワ	イワオ	ガン	ケワ	ヨシ
巍	ギ	タカ	タカシ
巎	ドウ
巐	チョウ
巒	ミネ	ラン
巓	イタダキ	テン
巖	イワ	イワオ	ガン	ケワ	ヨシ
巘	ケン	ゴン	ミネ
巙	キ	ドウ	ノウ
巛	カワ	セン	マガリガワ
川	カ/ガ	カワ/ガワ	コ/ゴ	サワ	セン
州	クニ	シュウ	ス/ズ
巠	キョウ	ケイ
巡	ジュン	マワ	メグ/メグリ
巣	ス/ズ	ソウ
巤	タテガミ	モト	リョウ
工	ク/グ	コウ	タク	タクミ/ダクミ	モク
左	サ/ザ	シャ	ソ	ヒダリ
巧	ウマ	カツ	コウ/ゴウ	タク/ダク	タクミ	ヨシ
巨	オオ	カ	キョ	コ	ナオ
巩	キョウ
巫	カンナギ	フ	ミコ
差	サ/サス/ザ	サシ/ザシ
己	オノ	オノレ	キ	コ/ゴ	シ	ツチノト	ナ	ミ
已	イ	スデ	ノミ	ハナハダ	ミ	ヤ
巳	シ	ミ
巴	ウズマキ	トモ	トモエ/ドモエ	トモミ	ハ/バ/パ
巵	サカズキ	シ
巷	コウ	チマタ
巸	イ	オオ	キ	ヒロイアゴ
巹	キン	サカズキ	シタガ	ノ
巻	カン/ガン	ケン	マ	マキ
巽	ソン	タツミ
巾	オオ	キレ	キン/ギン	チキリ	ハバ	フク	ベキ
帀	ソウ	メグ
市	イ	イチ	シ/ジ	チ
布	ウ	キレ/ギレ	シ/シキ	ヌノ	ノ	フ/ブ/プ	ホ
帆	カイ	ハン/パン	ホ/ボ
帇	テワザガスバヤイ	デン	ニョウ	ロウ
帋	カミ	シ
希	キ	ケ	コイネガ	コイネガワ	ノゾ	ノゾミ	マレ
帍	コ	ヒレ
帑	カネグラ	トウ	ド
帒	タイ	フクロ
帔	ヒ	フクロ
帕	ツツ	ハ	ハク	バツ	ヘ	ミャク	ミュク	メチ
帖	カキモノ	ジョウ	チョウ
帘	サケバタ	シン	ヨウ	レン
帙	チツ	フマキ
帚	シュウ	ソウ	ホウキ
帛	キヌ	ハク/パク
帝	テイ	ミカド
帟	エキ	ヒラトバリ	ヤク
帠	ゲイ	ノリ
帥	スイ	ソチ
帨	エチ	エツ	サイ	スイ	セイ	テフキ
師	イクサ	カズ	シ/ジ	ツカサ	ノシ	ノリ	ミツ	モト	モロ
席	セキ	セッ	ムシロ
帮	タス	ホウ
帯	オ	オビ	タイ	タテ
帰	オク	カエ/ガエ	キ	トツ
帲	オオ	ヒョウ	ヘイ
帳	チョウ	トバリ
帵	エン	オン	ワン
帶	オ	オビ	タイ
帷	イ	トバリ
常	ジョウ	ツネ/ヅネ	トキ	トコ	ノブ	ヒ	ヒサシ	ヒタ
帽	オオ	ズキン	ボウ	モウ
帾	ツ	ト	ハタ	ハタジルシ	ワタイレ
幀	チョウ	テイ	トウ
幃	イ	キ	トバリ
幄	アク	トバリ
幅	ハバ	フク/ブク/プク
幇	タス	ホウ
幉	タヅナ
幋	アタマノカザリ	ハン
幌	コウ	トバリ	ホロ/ボロ/ポロ
幎	トバリ	ベキ
幐	トウ	ニオイブクロ	フクロ
幑	キ	ハタ	メジルシノヌノ
幔	バン	マク	マン
幕	トバリ	バク	マク
幖	シルシ	ノボリ	ハタ	ヒョウ
幗	カク
幘	サク	シャク	ズキン
幛	ショウ	ヌノ
幜	カズキ	キヌ	キョウ	ケイ
幞	ズキン	ホク
幟	シ	ノボリ
幡	ハ	ハタ/バタ	ハン/バン	ホン	マン	ワタ
幢	トウ	ハタ
幣	シデ	ヌサ	ヘイ/ベイ	ヘコ
幤	ヌサ	ヘイ
幨	セン	タチキ	トバリ	ホロ
幪	フクサ	ボウ	ム	モウ
幫	タス	ホウ
幬	ジュ	チュウ	トウ	トバリ
幭	オオイ	バツ	ベツ	マチ	メチ
幮	カヤ	ジュ	チュ	チュウ	トバリ
幰	ケン	コン	ホロ
干	カン	ヒ/ヒア/ビ	ホ/ボ	ホシ/ボシ
平	ガナル	タイ/ダイ	タイラ/ダイラ	タダシ	タラ	ハチ	ヒ	ヒトシ	ヒョウ/ビョウ/ピョウ	ヒラ/ビラ/ピラ	ヘ/ベ	ヘイ/ベイ/ペイ	ヘン/ペン
年	トシ/ドシ	ネ	ネン	ミノル
幵	ヘイ
并	アワ	ナラ	ヒョウ	ヘイ
幸	コ	コウ/ゴウ	サイ	サイハ	サイワ/ザイワ	サイワイ	サキ	サシ	サチ	サッ	サヤ	シアワ	トモ	ヒロ	ミユキ	ユ	ユキ	ヨシ
幹	エダ	カン	キ	クル	タカシ	ツネ	ツヨシ	トモ	マサ	ミ	ミキ	モト	モトキ	ヨシ	ヨリ
幺	イトガシラ	チイサイ	ヨウ	ヨウヘン
幻	ゲン	マボロシ
幼	ウブ	オサナ	ヨウ	ワカ
幽	カス	カソケ	クラ	シロ	フカ	ユウ
幾	イ	イク/イッ	キ	ク
广	ゲン	マダレ
庀	オサ	ハイ	ヒ	ヘイ
庁	チョウ	テイ	ヤクショ
広	コウ	ヒロ/ヒロガ/ビロ/ピロ	ヒロシ
庄	ショウ/ジョウ	ソ	ソウ	ホウ	マサ
庇	オオ	カバ	ヒ/ピ	ヒサシ/ビサシ
床	ショウ	トコ/ドコ	ユカ
庋	キ	トダナ
庎	カイ	タナ	ナガシ
序	ジョ	ツイ	ツイデ	ツグ
底	ソコ/ゾコ	テイ
庖	クリヤ	ホウ/ボウ
店	タナ/ダナ	テン/デン	ミセ
庚	カノエ	コウ
府	イ	ウ	オ	ハン	フ/ブ/プ
庠	ショウ	マナビヤ
庢	サエギリトド	チチ	チツ	テイ
庤	ジ	タクワ	チ
庥	カゲ	キュウ	ク
度	タ	タク	タビ	ト/ド	ドシ	ノリ
座	ザ	スワ/ズワ
庨	キョウ	コウ
庪	キ
庫	ク	クラ/グラ	コ/ゴ
庬	ハッキリ	ボウ	モ	モウ
庭	テイ	ニワ	バ
庱	チョウ	リョウ
庳	ヒ	ヒク
庵	ア	アン	イ	イオ	イオリ	イホリ
庶	ショ
康	カン	コ	コウ	ミチ	ヤス	ヤスシ
庸	イサオ	ツネ	ノブ	ヤス	ヨウ
庽	カコツ	グ	グウ	ドウ	ヨ
庾	クラ	ユ
庿	タマヤ	ビョウ	ミタマヤ	ミョウ	ヤシロ
廁	カワヤ	シ	ショク
廂	ショウ	ソウ	ヒサ	ヒサシ
廃	スタ	ハイ/パイ
廆	エ	カイ	カキ	ケ
廈	イエ	カ	サ
廉	カド	キヨ	レン
廊	ロウ
廋	カク	シュ	シュウ	ス	ソウ
廌	チ
廎	イエノカタワラ	キョウ	ケイ	テイ
廏	ウマヤ	キュウ
廐	ウマヤ	キュウ
廑	キン	コン
廒	ゴウ
廓	カク	クルワ	トリデ
廔	ノキ	マド	ムネ	リュ	ル	ロウ
廕	イン	オオ	オン	カゲ	カバ
廖	リョウ
廚	クリヤ	シュウ	ズ	チュ	チュウ
廛	タナ	テン	ミセ	ヤシキ
廜	イオリ	ツ	ト
廝	コモノ	シ
廞	オコ	カン	キン	ケワ	ケン	コン	ツラ
廟	タマヤ	ビョウ	ミタマヤ	ミョウ	ヤシロ
廠	ショウ
廡	シゲ	ヒサシ	ブ
廢	スタ	ハイ
廣	コウ	ヒロ	ヒロシ
廥	カイ	クラ	ケ	マグサグラ
廨	カイ	ケ	ヤクショ
廩	クラ	リン
廫	ウツロ	ムナ	リョウ	ロウ
廬	イエ	イオ	イオリ	リョ	ロ
廰	チョウ	テイ	ヤクショ
廱	ヤワラグ	ヨウ
廳	チョウ	テイ	ヤクショ
廴	イン	インニョウ	エンニョウ
延	エン	タカ	ノ/ノバ/ノビ	ノブ	ノベ
廷	タカ	テイ
廸	イタ	スス	テキ	ミチ	ミチビ
建	ケン	コン	タ/タチ/ダ	タケ	タケシ	タチ/ダチ	タツ	タテ/ダテ
廻	エ	カイ/ガイ	ザコ	ジャク	マワ/マワシ/マワリ	メグ/メグリ	モトオ
廼	アイ	スナワ	ダイ	ナイ	ナンジ	ノ
廾	キョウ	ク	ニジュウ	ニジュウアシ
廿	ジュウ	ニジュウ	ニュウ	ハツ
弁	アラソ	カンムリ	ハナビラ	ヘン/ベン	ベ	ワ	ワキマ
异	ア	イ
弃	キ	ステ
弄	イジ/イジリ	イジク	イラ	タワム	ヒネク	モテアソ	ル	ロウ
弆	オサ	キョ	コ	シマイコ
弇	エン	オオ	カン	コン	ダン	ナン
弈	エキ	ヤク
弉	サカン	ジョウ	ソウ
弊	ヘイ
弋	イグルミ	シキガマエ	ヨク
弌	イチ	イツ	ハジメ	ヒト	ヒトツ
弍	ジ	ニ	フタ	フタタ
弎	サン	ゾウ	ミ	ミッ
式	シキ/ジキ	ノリ
弐	ジ	ソエ	ニ	フタ
弑	シ	シイ
弓	キュウ	コ	ユ	ユミ
弔	チョウ	トブラ	トムラ	リ
引	イナ	イン	ヒ/ヒク/ヒッ/ビ/ピ	ヒキ/ビキ/ピキ	ヒケ
弖	テ
弗	ズ	ドル	フツ/フッ	ホチ
弘	オ	グ	コウ	コオ	ヒロ/ビロ	ヒロシ	ヒロム	ミツ
弙	ウ	オ	ク	コ	モ	ユミヲハッテネラ
弛	シ	タユ	タル/ダル	ダ	チ	ユル
弜	キ	キョウ	ゴウ	ツヨ	ツヨイユミ
弝	ツカ	ハ	ヘ	ユヅカ
弟	オトウト	ダイ	テ/デ	テイ
弡	クツ	グチ	チョウ	ツヨクイサマシイ
弢	トウ	ユミブクロ
弣	フ	ユヅカ
弤	タイ	チュウ	テイ
弥	アマネシ	イヤ	イヨイヨ	トオイ	ヒサ	ヒサシ	ヒロ	ビ	ミ	ミツ	ヤ	ヨ	ワタ	ワタル
弦	ゲン	ツル/ヅル
弧	コ
弨	ショウ	ソリカエ
弩	イシユミ	オオユミ	ド
弫	シン	ユミガツヨイ
弬	イ	ユミノナ
弭	ビ	ミ	ヤ	ユハズ
弮	イシユミ	ケン	マ	マキ
弯	ヒ	ワン
弰	ショウ	ソウ	ユハズ
弱	ジャク/ジャッ	ヨワ
弴	チョウ	トン
張	チョウ	ハ/バ/パ	ハリ/バリ/パリ	バ/バル	ワリ
弶	アミヲハ	キョウ/ギョウ	ゴウ	ワナヲカ
強	キョウ	コワ/ゴワ	ゴウ	シ/ジ	シタタ	スネ	ツトム	ツヨ/ヅヨ	ツヨシ
弸	ホウ
弻	タス	ヒツ	ユダメ
弼	スケ	タス	タスク	ヒツ	ユダメ
弽	キョウ	ショウ	ユガケ	ヨウ
弾	タダ	タマ/ダマ	タン/ダン	ハジ	ハジキ	ハズ	ヒ/ヒキ/ビ	ヒキ/ビキ
弿	ケン	コン	ユミガツヨイ
彀	ク	コウ
彁	カ	セイ
彄	ク	コウ	ユガケ	ユハズ
彅	ナギ
彇	ショウ	ユハズ	ヨウ
彈	タダ	タマ	タン/ダン	ハジ	ハズ	ヒ
彊	キョウ	ゴウ	ツヨ	ツヨシ
彌	アマネシ	イヤ	イヨイヨ	トオイ	ヒサ	ヒサシ	ビ	ミ	ヤ	ユ	ワタ
彍	カク	ハ	ハシ
彎	ヒ	ワン
彐	ケイ	ケイガシラ
彑	ケイ	ケイガシラ
当	ア/アテ	アタ	タイ	トウ/ドウ	マサ
彔	キザ	ロク
彖	タン
彗	エ	ケイ	スイ	セイ	トシ	ホウキ
彘	エ	エイ	テイ	ブタ
彙	イ	ハリネズミ
彛	イ	ツネ
彜	イ	ツネ
彝	イ	ツネ
彠	カク	キャク	ノリ	ハカ	モノサシ	ヤク	ワク
彡	カミカザリ	サン	サンヅクリ	セン
形	カタ/ガタ/ガダ	カタチ	ギョウ	ケイ	チ	ナリ
彣	アヤ	ブン	モン
彤	アカ	ズ	トウ
彦	ゲン	コ	ヒコ	ヒロ	ヤス	ヨシ
彧	アヤ	イク
彩	アヤ	イロド	イロドリ	サ	サイ	サエ	ツヤ
彪	アキラ	アヤ	カオル	タケ	タケキ	タケシ	ツヨシ	トラ	ヒュウ	ヒョウ/ピョウ
彫	エ	チョウ	ホ/ホリ/ボ	ボリ
彬	アキ	アキラ	ウルワ	ヒトシ	ヒン	フン	ヨシ
彭	ホウ
彯	ビョウ
彰	アキ	アキラ	ショウ
影	エイ	カゲ
彲	チ	ミズチ
彳	ギョウニンベン	タタズ	テキ
彴	シャク	チャク	テキ	ハク	マルキバシ
彵	シズカニユ	タ
彷	サマヨ	ホウ
彸	シュ	ショウ
役	エキ	チャク	ヤク
彺	イソギユ	オウ
彼	ア	カ	カノ	カレ	ソノ	ヒ
彽	ジ	タイ	タチモトホ	チ	テイ	デ
彾	リョウ	レイ
彿	フツ
往	イ	イニシエ	オウ	サキ	ミチ	ユ
征	イク	ススム	セイ	ソ	タダ	タダシ	マサ	ユ/ユク	ユキ
徂	ソ	ユ
徃	イ	イニシエ	オウ	サキ	ミチ	ユ
径	ケイ	コミチ	サシワタシ	タダチニ	ミチ
待	タイ	マ	マチ	マツ
徇	アマネシ	シタガ	シュン/ジュン	トナ
很	ギン	コウ	コン	モト
徉	サマヨ	ヨウ
徊	エ	カイ	クワイ	サマヨ
律	タカシ	タダシ	ノリ	リチ	リツ/リッ	レツ
後	アト	ウシ	ウシロ	オク	コウ/ゴウ	コシ	ゴ	シ	シイ	シリ/ジリ	ノチ	ラ
徍	ア	アイ	エ	ユ
徏	スス	チョク	トク	ノボ
徐	オモム	オモムロ	ジョ
徑	ケイ	コミチ	サシワタシ	タダチニ	ミチ
徒	アダ	イタズラ	オカチ	カチ	タダ	ト	ムダ
従	シタガ	ショウ	ジュ	ジュウ	ツ	ヨリ
徖	ス	ソウ	ヤス
得	アツ	ウ	エ	テロ	トク/ドク
徘	サマヨ	ハイ
徙	ウツ	シ
徜	サマヨ	ショウ
徝	チ	チキ	チョク	ノボ	ホドコ
從	シタガ	ショウ	ジュ	ジュウ	ヨリ
徠	キタ	ク	ライ
御	ウ	オ	オン	ギョ	ゴ	ミ
徢	ショウ
徤	ケン	スコ	タケシ
徧	アマネ	ヘン
徨	コウ	サマヨ
復	フク/フッ/プク	マタ
循	ジュン
徫	イ	ヤ
徬	ツキソ	ホウ
徭	エウ	エダチ	ツカイ	フゾロ	ヨウ
微	カス	ビ	ミ
徯	ケイ	コミチ	モ
徰	イク	セイ
徱	カル	カロ	スバヤ	ヒョウ
徳	アツ	イサオ	トク/トッ/ドク	ナル	ノリ	ユキ	ヨシ
徴	シルシ	チ	チョウ
徸	イ	シュ	ショウ
徹	アキ	ツ	テツ/テッ	トオ	トオル
徼	キョウ	メグ	ヨウ
徽	キ	シルシ
心	ココロ/ココロガ/ゴコロ	シン/ジン	リッシンベン
忄	ココロ	シン	リッシンベン
必	カナラ	ヒツ/ヒッ
忇	オモ	コウロウガオオキイ	ロク
忈	シタ	ジン	ニン
忉	ウレ	トウ
忋	アオ	カイ	タノ
忌	イ/イミ/イム	イマ	イマワ	キ
忍	オシ	シノ	シノビ	シノブ	ニン
忐	キョウ	クン	コウ	タン	ムナ
忑	トウ	トク	ムナ
忒	カ	トク
忓	オカ	カン	キワ
忔	キ	キツ/ギツ	コチ	コツ	ヨロコ
忖	ソン	ハカ
志	ココロ	ココロザ	ココロザシ	シ/ジ	シムラ	シリング	ジン	ベ	ベシ	ユキ
忘	ボウ	ワス	ワスレ
忙	イソガ	ウレエルサマ	オソ	セワ/ゼワ	ボウ	モウ
応	アタ	イラ	オ	オウ	コタ/ゴタ	タカ	ノウ	マサ	マサニ	ヨウ
忝	カタジケ	カタジケナ	テン
忞	ツト	ビン	ブン	ミン	モン
忠	キヨシ	タタ	タダ	タダシ	チュウ	ナオ
忡	ウレ	シュ	シュウ	チュ	チュウ
忢	ゴ	サト	サトリ
忤	ゴ	サカラ	モト
忨	ガン	ムサボ
忩	アワ	ソウ	ニワカ
忪	オドロ	シュ	ショウ
快	カイ	ココロヨ	ヨシ
忬	アラカジメ	ショ	ヤス	ヨ
忭	タノ	ヘン
忮	キ	サカ	シ
忯	キ	シ	ツツシ
忰	カ/カセ	スイ	セガレ	ヤツ
忱	シン	マコト
忲	タイ	ナラ
忳	ウレ	シュン	トン
念	ネン
忶	ウン	コン	マヨ	モダ
忸	ジク	ジュウ	ハジ
忺	ケン	コン	ノゾ
忻	キン	ヨロコ
忼	アナド	コウ	ナゲ	ヒョウ	ホウ
忽	コツ/コッ	タチマ	ヌ	ユルガ
忿	イカ	イカリ	フン
怇	アナド	キョ	キョウ	ゴ
怊	イタ	カナ	ショウ	チョウ
怍	サ	サク	ジャ	ハジ
怎	イカデ	シン	ソ	ナンゾ
怏	ウラ	オウ	ヨウ
怐	ク
怒	イカ	オコ	ド	ヌ
怓	ドウ	ニュ	ニョウ	ミダ
怔	オソレアワ	ショウ	セイ
怕	オソ	カシワ	ハ	ハク	ヒャク
怖	オ/オジ	オソ/オゾ	コワ	フ	ホ
怗	オダ	シタガ	セン	チョウ	テン
怘	カタ	カタク	ク	コ
怙	コ	タノ
怚	オゴ	ショ	ソ
怛	イタ	タツ/ダツ	タン
怜	アワ	サト	サトシ	リョウ	レイ	レン
思	オボ	オモ/オモイ	オモエラ	シ/ジ
怟	タイ	テイ	モダ
怠	オコタ	タイ	ダル	ナマ
怡	イ	ヨロコ
怤	オモ	フ	ヨロコ
急	イソ/イソギ	キュウ	セ
怦	ヒョウ	ホウ
性	サガ	ショウ/ジョウ	セイ
怨	ウラ	ウラミ	ウン	エン	オン
怩	ジ
怪	アヤ	カイ	ケ
怫	ハイ	ヒ	フツ
怭	アナド	ヒツ	ビチ
怯	オジル	オソ	オビ	オビエ	キョウ	コウ	ヒル
怱	アワ	サト	ソウ	ニワカ
怳	キョウ	クル	シュツ	チュツ
怵	オソ	シュチ	シュツ	チュツ
怺	コラ
恀	シ	タノ
恁	イン	ジン	ニン
恂	シュン/ジュン	マコト
恃	シ/ジ	タノ
恆	コウ	ツネ	ヒサシ	ワタル
恇	キョウ	コウ	ツネ
恈	ボウ	ム	ムサボリオシム
恉	ココロ	シ
恊	アワ	カナ	キョウ
恋	コ	コイ/ゴイ	レン
恌	ウス	チョウ	ヨウ
恍	コウ	トボ	ホ
恐	オソ/オソレ	キョウ	コワ/ゴワ
恑	アヤ	カ	キ
恒	コウ/ゴウ	ツネ/ヅネ	ツネニ	ノブ	ヒサ	ヒサシ
恔	キョウ	コウ	サトイ
恕	ショ/ジョ	ユル
恖	オボ	オモ	オモエラ	コト	サイ	シ
恗	ウレ	オソ	カ	ク	ケ	コ	ホコ
恙	ツツ	ツツガ	ヨウ
恚	イ	イカ
恝	カイ	カツ	ケチ
恟	オソ	キョウ
恠	アヤ	カイ	ケ
恡	オ	ネタ	ヤブサカ	リン
恢	カイ	ケ	ヒロ
恣	シ	ホシイママ
恤	アワ	ウレ	シュツ/ジュツ	ジュツ/ジュッ	メグ
恥	チ	ハ	ハジ	ハズカ	ヤサ
恧	ジク	ジョク	ニク	ニョク	ハジ
恨	ウラ	コン
恩	オン	メグミ
恪	カク/カッ	ツツシ	ツトム
恫	イタ	トウ/ドウ
恬	テン	ヤス	ヤスラ
恭	ウヤウヤ	キョウ	キヨ	ヤス	ヤスシ	ユキ	ヨシ
息	イキ	ソク/ソッ	ヤス
恰	アタカ	カッ	キョウ	コウ	チョウ
恱	エチ	エツ	ノブ	ヨシ	ヨロコ
恵	アヤ	エ	ケ	ケイ	サト	サトシ	シゲ	ヘイ	ミ	メグ/メグム	メグミ	ヤス
恷	キュウ	ク	ヤス	ヨシ
恾	イソガ	ウレ	オソ	セワ	ボウ	モウ
恿	イサ	ツ	トウ	ユ	ヨウ
悁	エン	ケン
悂	アヤマ	ツツシ	ヒ	ヘイ
悃	コン	マゴコロ
悄	ウレ	ショ	ショウ
悆	ショ	ソ	ヨ	ワス
悈	カイ	カク	キョク	コク	トトノ
悉	コトゴト	シチ	シツ/シッ	ツ	ツブサ
悊	ウヤマ	テチ	テツ
悋	オ	ネタ	ヤブサカ	リン
悌	ダイ	チカ	テイ	トモ	ヤス	ヤスシ	ヨシ
悍	アラシ	カン	タケシ
悎	オソ	カク	キョウ	コウ	コク
悑	オ	オソ	コワ	フ	ホ
悒	ウレ	フサ	ユウ
悓	ウカガ	ケン	タト
悔	カイ	ク/クイ	クヤ
悕	オモ	カナシ	キ	ケ
悖	ハイ	ボツ	モト
悗	バン	マン
悘	イ	ウヤウヤ	エイ	ツマビ
悚	オソ	ショウ
悛	アラタ	シュン	セン
悝	カイ	タワム	リ
悞	アヤマ	ゴ
悟	ゴ	サト	サトシ	サトル
悠	ハルカ	ユ	ユウ
悢	カナ	コウ	リョウ
患	カン	クロ	ワズラ
悤	アワ	ソウ	ニワカ
悥	オク	ミ	ヨク
悦	エツ/エッ	ヤ	ヨシ	ヨロコ
悧	リ
您	シカリ	ジ	ソノ	ナンジ	ニ	ノミ
悩	ナヤ	ナヤミ	ノウ
悪	ア	アア	アク/アッ	イズクニ	イズクンゾ	オ	ニク	ワル
悰	ズ	ソウ	タノ
悱	イイナヤ	ヒ
悲	カナ/ガナ	ヒ
悳	イサオ	トク
悴	カジカ	スイ	セガレ	ヤツ
悵	イタ	ウラ	チョウ
悶	モダ	モダエ	モン
悷	カナ	ライ	リ	レイ
悸	キ
悻	ギョウ	ケイ	コウ	モト
悼	イタ	トウ
悽	イタム	セイ
悾	ク	コウ
惂	ウレエクルシム	カン	コン
惄	デキ	ヒモジイ
情	ジョウ	セイ/ゼイ	ナサ	ナサケ
惆	ウラ	チュウ
惇	アツ	アツシ	シュン/ジュン	ツトム	トシ	トン	マコト
惈	イサ	カ
惉	セン	ヤブ
惊	カナ	リョウ
惋	ナゲ	ワン
惎	キ	ソコ
惏	ムサボ	ラン	リン
惑	マド	ワク
惓	ウム	ケン
惔	ウレ	エン	タン	テン	ネン
惕	チャク	ツツシ	テキ
惘	アキ	ボウ	モウ
惙	ウレ	テイ	テチ	テツ
惚	コツ	トボ	ホ/ボ	ホウ	ホケ/ボケ	ボウ
惛	オロ	コン	ビン	ミン
惜	オ	セキ
惝	ウットリ	ショウ	トウ
惞	キン	コン	ヨロコ
惟	イ	オモ	オモン	コレ	タダ	ノブ	ユイ	ヨシ
惠	エ	ケイ	メグ	メグミ
惡	ア	アア	アク	イズクニ	イズクンゾ	オ	ニク	ワル
惢	ウタガ	サ	スイ	ニ
惣	アシム	オサム	スベ	ソ	ソウ	フサ	ミチ
惥	スス	ヨウ
惧	オソ	ク	グ
惨	イタ	サン/ザン	ミジ	ムゴ
惰	ダ
惱	ナヤ	ナヤミ	ノウ
惲	アツ	ウン	キン
想	オモ	ソ	ソウ
惴	オソ	スイ/ズイ
惵	キョウ	ジョウ	チョウ	ヤス
惶	オソ	コウ
惷	シュン
惸	ウレ	ギョウ	ケイ
惹	ジャ	ジャク/ジャッ	ヒ
惺	サト	セイ
惻	イタ	ショク	ソク
惼	セマ	ヘン
惽	コン	ビン
愀	シュウ	ショウ
愁	ウレ	シュウ
愂	ハイ	ボツ	モト
愃	カン	ケン
愆	アヤ	ケン
愇	アサ	イ	ウラ	ヨイ
愈	イヨイヨ	マサ	ユ
愉	タノ	ユ	ユウ
愊	ヒキ	ヒョク	フク	マコト
愌	カン	ハビコ
愍	アワ	ビン	ミン
愎	ヒョク	フク	モト
意	イ	モト	ヨシ
愐	ツト	ベン	メン
愑	イカ	ミツ	ユ	ヨウ
愒	イコ	カイ	ケイ	ケチ	ケツ
愓	ショウ	トウ	ホシイママ	ヨウ
愔	アン	イン	オン	ヤワ
愕	オドロ	ガク
愖	シン	タノ	タン	トン	マコト
愗	オロ	ボウ	モ	ヤブサカ
愙	カク	ツツシ
愚	オロ	グ
愛	ア	アイ	アシ	イト/イトシ	エ	オ	カナ	チカ	ナル	マナ	メ/メデ	メグ	メグミ	ヨシ
愜	キョウ	ココロヨ
愞	オソ	ゼン	タ	ナ	ネン	ヨワ
感	カン/ガン
愡	ソウ
愢	ココロガタガ	サイ	シ	セ
愧	キ	トガ	ハジ	ハズカシ
愨	カク	ツツシ	マコト
愪	イン	ウゴ	ウレ	ウン
愫	ソ	マコト
愬	ウッタ	サク	ソ
愰	オウ	コウ	サトイ
愱	クル	シチ	シツ
愴	イタ	イタマ	ソウ
愵	ウレ	デキ	ニャク
愶	オビヤ	キョウ	コウ
愷	カイ	タノ
愹	イカ	ミ	ヨウ	ヨロコ
愼	シン	ツツシ
愽	タン
愾	ガイ	キ	キツ	ケ	タメイキ
愿	ゲン	スナオ	ツツシ
慁	ウレ	コン
慂	スス	ヨウ
慄	オソ	オノノ	フル	リツ
慅	ウゴ	ショウ	ソウ
慆	タク	トウ	ヨロコ
慇	イン
慈	イツク	シゲ	ジ	チカ	メグミ	ヨシ
慉	オコ	キク	キョウ	キン
慊	アキタリル	ウラ	キョウ	ケン
態	タイ/ダイ	ワザ
慌	アワ	アワタダ	コウ
慍	イカ	ウラ	ウン	オン
慎	シン	チカ	ツツ	ツツシ	ツツマ	ノリ	マキ	マコト	ミツ
慓	ヒョウ
慕	シタ	ボ
慘	イタ	サン	ミジ	ムゴ
慙	ザン	ハジ
慚	ザン	ハジ
慝	トク	ワル
慞	オソ	ショウ
慟	トウ/ドウ	ナゲ
慠	ウレ	オゴ	ゴウ
慢	マン
慣	カン	ナ/ナラ
慥	ゾウ	タシ
慧	アキラ	エ	ケイ	サト	サトイ	サトシ	サトル	トシ
慨	ガイ
慫	ショウ	スス
慬	カナ	キン	コン
慮	オモンバカ	オモンパカ	オモンパク	ゼ	リョ
慯	ショウ
慰	イ	ナグサ
慱	タン
慲	バン	マン	ワス
慳	オシ	カン	ケン
慴	オソ	シュウ	ショウ
慵	ショウ	モノウイ	ヨウ
慶	キ	キヨン	ケ/ゲ	ケイ/ゲイ	ミチ	ム	ヤス	ヨシ	ヨロコ
慷	コウ	ナゲ
慸	オト	キワ	セイ	タイ	タカ	テイ
慻	カエリ	ケン
慼	ウレ	シャク	シュク	セキ
慾	ヨク
慿	タノ	ツ	ツカ	ヒョウ	ヨ
憀	リュウ	リョウ	ル
憁	ソウ
憂	ウ	ウレ	ユ	ユウ
憃	オロ	シュ	ショウ	チュ	チョウ	トウ
憄	チ	ホドコ
憇	イコ	ケイ
憊	ツカ	ハイ/パイ	ヘイ
憋	セッカチ	ヘチ	ヘツ
憍	キョウ	ホシイママ
憎	ゾウ	ニク
憐	アワ	レン
憑	タノ	ツ/ツキ	ツカ	ヒョウ/ピョウ	ヨ
憒	カイ	ミダ
憓	イツク	エ	ケイ
憔	ショウ	セウ	ソウ	ヤセ	ヤツ
憖	キン/ギン	ナマジ
憗	キン	ナマジ
憘	アア	キ	コノ	ヨロコ
憙	アア	キ	コノ	ヨロコ
憚	タ	タン	ハバカ
憜	タ/ダ	ツツシマナイ
憝	ウラ	ズイ	タイ
憟	ショク	ソク	ヘツラ
憠	ケツ	ツヨ
憤	イキドオ	フン/プン
憥	クル	ロウ
憧	アコガ	ショウ	トウ/ドウ
憨	オロ	カン
憩	イコ	イコイ	ケイ
憪	カン	ゲン	タノ
憫	アワレ	ウレ	ビン	ミン
憬	アコガ	ケイ
憭	サトイ	リョウ
憮	イツクシ	コ	ブ
憲	カズ	ケン	ノリ	ヨシ
憶	オク	オボ
憸	カタヨ	ケン	セン
憹	ココロミダ	ドウ	ナヤ	ニョウ	ヌ	ノウ
憺	タン
憼	キョウ	ケイ	コウ	ツツシ
憾	ウラ	カン
懀	エ	ニク	モダ	ワイ	ワチ	ワツ
懁	カン	ケン	ハゲ
懂	ツ	トウ	ミダ
懃	キン/ギン	ゴン	ネンゴロ
懆	ソウ
懇	コン	ネンゴ
懈	オコタ	カイ	ケ	タユ	タワ
應	アタ	オウ	コタ	マサニ	ヨウ
懊	オウ	ジレッタ	ナヤ
懋	シ	ツト	ボウ
懌	エキ	ヨロコ
懍	ラン	リン
懎	ウラ	カナ	シキ	ショク
懏	サトイ	シュン
懐	イダ	エ	オモ	カイ	カネ	ナズ	ナツ/ナツカ/ナヅ	フトコロ/ブトコロ
懕	エン	タ	ヤス	ユル	ヨウ
懜	クラ	ボウ	ム	モウ
懝	オソ	オロ	ガイ	ギ	ギョク	ゴキ	ハカ
懞	アツ	ボウ	ム
懟	ウラ	ズイ	タイ	ツイ
懡	バ	マ
懢	カン	ゲン	スコ	ムサボ	ラン
懣	マン	モダ	モン
懥	チ
懦	ジュ	ゼン	ダ	ヨワ
懧	ジュ	ゼン	ダ	ヨワ
懩	ネガ	ヨウ
懬	オオ	コウ	ツヨ	ヒロ	ムナ
懭	ウラ	コウ
懯	オモ	フ
懲	コ/ゴ	チョウ
懴	クイ	サン/ザン
懶	オコタル	モノウ	モノウイ	ライ	ラン
懷	イダ	エ	オモ	カイ	ナツ	フトコロ
懸	カ/ガ	カカ	カケ	ガカ	ケ	ケン
懺	クイ	サン/ザン
懼	オソ	ク
懽	カン	ヨロコ
懾	オソ	ショウ
懿	イ	ヨイ
戀	コ	コイ	レン
戁	ゼン	ダン	ツツシ	ネン
戃	オドロ	ショウ	トウ
戄	オドロ	キャク	ショウ
戇	オロ	ク	コウ	シュ	チュウ	トウ
戈	カ	カノホコ	ホコ	ホコヅクリ
戉	エツ	エビス	ジュウ	マサカリ
戊	ツチノエ	ボ	ボウ
戌	イヌ	ジュツ
戍	シュ/ジュ	マモ	マモリ
戎	エビ	エビス	ジュウ	ツワモノ
成	アキ	アキラ	シゲ	シゲル	ジョウ	セイ/ゼイ	ソン	タエ	ナ/ナシ/ナラ/ナリキ	ナオ	ナリ	ナリキ/ナリギ	ナル	ノリ	ヒラ	マサ	ヨシ	リ
我	ア	アガ	カ/ガ	ワ	ワガ	ワレ
戒	イマシ	カイ/ガイ
戓	カ
戔	サン	セン
戕	コロ	サン	ショウ	ソウ
或	ア	アル	アルイ	アルイハ	イキ	コク	ワク
戚	イタ	ウレ	セキ	ソク	ミウチ
戛	カツ	ホコ
戜	キ	スルド	テツ	デチ
戝	サイ/ザイ	ゾク
戞	カツ	ホコ
戟	ゲキ	ホコ
戠	シ	シキ	ショク
戡	カツ	カン	サス	チン
戢	オサ	シュウ
戣	キ	ホコ
戦	イクサ	オノノ	セ	セン	ソヨ	タタカ	ワナナ
戧	キズ	ショウ	ソウ	ツク	ハジ
戩	セン	ホロ
截	キ	サイ	セツ	タ
戫	イキ	ハヤ	ヨク
戮	キョウ	ク	ケズ	コロ	リク	リュウ	ロク
戯	オド	オドケ	ギ	ゲ	ザ	ジャ	タワ	タワム
戰	イクサ	オノノ	セン	ソヨグ	タタカ
戲	ギ	ゲ	タワム
戳	タク
戴	イタダ	タイ/ダイ
戸	エ	コ/ゴ	ト/ド	ヘ/ベ
戹	アク	セク	セマ
戻	モド/モドリ	モドシ	レイ
戽	アカクミ	ク	コ
房	オ	ノブ	フサ/ブサ	ボウ	ワ
所	ショ/ジョ	セ/ゼ	トコ/ドコ	トコロ/ドコロ	ド
扁	ヒラタイ	ヘン
扂	カンヌキ	テン	トザシ
扃	カンヌキ	キョウ	ケイ	トビラ	ヘン
扄	ショウ
扆	イ	エ	ツイタテ
扇	アオ	オウ	オウギ	オオギ	セン
扈	コ	シタガ
扉	トビラ	ヒ/ピ
手	シュ/ジュ	ズ	タ	テ/テガ/テグ/テバ/デ
扌	シュ	テヘン
才	サイ/ザイ
扎	アツ	サツ
扐	リキ	リョク	ロク
扑	カルクウ	ハク	フ	ホウ	ボク	ムチウ
扒	サバ	ヌ	ハイ	ハチ	ハツ
打	ウ/ウタ/ウチア/ウッ/ウツ	ウチ	ダ	ダアス	ブ/ブッ
扔	ジョウ	ス	ニョウ	フ	ヨ
払	ハラ/バラ/パラ	ハライ/バライ	ヒツ	フツ/フッ	ホツ/ホッ
扖	シボ	ハ
托	タク	タノ
扚	シャク	チャク	チョウ	テキ	ハヤクウツ
扛	ア	コウ
扜	ウ	ク	サシマネ
扞	カン	フセ
扠	サ	サテ
扣	コウ	タタ	ヒカ
扤	ウゴ	ガチ	ゲツ	ゴチ	ゴツ
扨	サ	サテ
扭	ジュウ	チュ	チュウ	ニュ	ネジマワ
扮	ハン	フン	ヘン	ヤツ	ヨソオ
扯	シャ	タ	ヒ
扱	アツカ	キュウ	コ/コキ	シゴ	ソウ
扳	サ	ハン	ヒ	ヒキトメル
扶	タス	フ
批	ヒ
扺	ア	シ	テイ
扼	アク	オサ	ヤク
扽	トン	ヒ
找	ソウ
承	ウ	ウケタマワ	コ	コト	ササ	ショウ/ジョウ	スク	スケ	ツイ	ツギ	ツグ	トド	ヨシ
技	ギ	ワザ
抂	キョウ	ゴウ
抃	ウ	ベン
抄	サ	ショウ	ス/スキ/スク	リ
抉	エグ	エグリ	クジ	ケツ	コ	コジ
把	タバ	ハ/バ/パ	ワ
抍	ア	ショウ	スク	ト	ヌ
抎	イン	ウシナ	ウン	オ
抏	ガン	クジク
抐	イ	ウ	ソ	ソン	ツカ	ドウ	ドツ	ドン	ナチ
抑	オサ	ソモソモ	ヨク
抒	ク	ショ/ジョ	ノ
抓	ソウ	ツ	ツネ	ツマ	ツメ
抔	スク	ナド	ハイ	ホウ
投	トウ	ナ/ナゲ
抖	ト	トウ
抗	アラガ	コウ
折	オ/オレ	オリ	シャク	セキ	セツ/セッ
抛	ナゲウ	ホウ
抜	ヌ/ヌク/ヌケ	ヌキ	ハイ	ハツ/バツ	バツ/バッ
択	エラ	タク	ヨ
抦	ヒョウ	ヘイ	モ
抨	ハジ	ヒョウ	ホウ
披	ヒ/ビ	ヒラ
抬	タイ	モタ
抱	イダ	カカ/ガカ	タバ	ダ/ダキ	ホウ/ボウ
抳	ジ	デイ	ト	ナイ	ニ
抵	テイ
抶	チチ	チツ	ムチウ
抷	ヒ	ヒラ
抹	マツ/マッ
抺	サグ	バイ	マイ	メ
抻	シン	チン
押	オ	オウ	オサ	オシ	オス	オッ	オヤ
抽	チュウ	ヌキ	ヒキ
抾	キョ	キョウ	コ	コウ	ト
抿	ナ	ビン	ミン
拂	ハラ	ヒツ	フツ	ホツ
拄	ア	チュ
担	カツ	タン	ニナ
拆	サク	セキ	タク	ヒラク
拇	オヤユビ	ボ
拈	セン	デン	ネン	ヒネ
拉	クダ	ヒシ	ラ	ラツ/ラッ	ロウ
拊	ウツ	ナ	ハ	フ
拌	ハン/パン
拍	ハク/パク	ヒョウ/ビョウ/ピョウ
拎	カ	リョウ	レイ
拏	ダ	ツカ	ナ	ヒ
拐	カイ	カドワ	サラ
拑	カン	ケン	ツグ
拒	キョ	コバ	ゴ
拓	タク	ツ	ツブセ	ヒラ	ヒロ
拔	ヌ	ハイ	バツ
拕	イ	タ	ヒ
拖	イ	タ	ヒ
拗	イク	オウ	コジ	ス	ネ	ネジ	ユウ	ヨウ
拘	カカ	カカワ	コウ	コダ	コダワ
拙	セツ/セッ	ツタナ
拚	テヲウ	フン	ヘン
招	ショウ	マネ/マネキ
拜	オガ	オロガ	ハイ
拝	オガ/オガミ	オロガ	ハイ/バイ/パイ
拠	キョ	コ	ヨ/ヨリ	ヨリドコロ
拡	カク	コウ	ヒロ
拪	イ	ウツ	セン
括	カツ/カッ	クク	ククリ	クビ	クル
拭	シキ	ショク	ヌグ/ヌグイ	フ/ブ
拮	カツ	キツ/キッ	ケツ	ハタラ
拯	ショウ/ジョウ	スク
拱	キョウ	コウ	コマヌ	コマネ
拲	キク	キョウ	キョク	ク	コク	テカセ
拳	ケン/ゲン	コブシ
拴	エラ	セン
拵	コシラ/ゴシラ	コシラエ	ゴシラエ	ソン
拶	サツ	セマ
拷	ゴウ
拼	シタガ	ヒョウ	ヘイ	ホウ
拽	エイ	エチ	エツ	セイ	ヒ
拾	シュウ/ジュウ	ジツ/ジッ	ヒロ/ヒロイ/ビロ
拿	ダ	ツカ	ナ	ヒ
持	ジ	モ/モテ	モチ	モツ/モッ
挂	カ	カイ	ケ	ケイ
挃	サ	ジチ	チツ	テツ	デチ
挄	カク	コウ	ヒロ
指	イ	イブ	サ/ザ	サシ	サス/ザス	シ	ユビ
挈	ケイ	ケツ	ヒッサ
按	アン	オサ	シラ
挊	イジ	イジク	タワム	ヒネク	モテアソ	ル	ロウ
挋	キン	コン	シン	タス
挌	ウ	カク
挍	キョウ	コウ	ハカ
挐	ジョ	ダ	ヒ
挑	イド	チョウ	ノゾ
挓	タ	ヒラ
挖	アチ	アツ	アバ
挘	ムシ	ムシリト
挙	ア/アガ/アゲ	キョ	コゾ	タカ
挟	キョウ	サシハサ	ショウ	ハサ/ハサミ/ハザ/バサ	ハサミ/バサミ	ワキバサ
挧	ウ	トチ
挨	アイ	ヒラ
挩	エイ	セイ	タチ	タツ	トク
挪	ダ	ナ	モ
挫	クジ	サ/ザ
挭	キョウ	コウ	ミダ
振	シン	フ/フル/フレ/ブ/プ	フリ/ブリ	フレ/ブレ	ブ/ブル
挵	イジ	イジク	セセ	タワム	ヒネク	モテアソ	ル	ロウ
挶	キョク	コク	ササ	モ
挹	オウ	ク	ユウ
挺	チョウ	テイ	ヌ
挼	オ	ダ	ダイ	ナ	ナイ
挽	バン	ヒ/ビ	ヒキ/ビキ
挾	キョウ	サシハサ	ショウ	ハサ/ハサミ/バサ	ハサミ/バサミ	ハザ	ワキバサ
挿	サ/サシ/ザ	ザシ	ス	ソウ	ハサ
捁	カク	コウ	ミダ
捂	ゴ	フ
捃	クン	ヒロ
捄	キュウ	ク	モ
捆	コン	トトノ
捉	サク	ソク	ツカ	トラ
捊	カキアツ	フ	フウ	ホウ
捋	ト	ラチ	ラツ	レチ	レツ
捌	サバ	ハ/ハケ	ハチ	ハツ	ベツ
捍	カン	フセ
捎	ショウ	ソウ	ト
捏	コ	ツク	テツ	デッ	ネ	ネチ	ネツ
捐	エン	ス
捒	ア	シュ	ショウ	ショク	ス	ソ	ソク	ツツシ
捓	モテアソ	ヤ	ヨ
捔	カク	サク	ト
捕	ツカ	ト/トリ/ド	トラ	ホ
捗	チョク	ハカ/バカ	ハカド	ホ
捘	オ	シュン	ソン
捛	トモ	リョ
捜	サガ	シュ	シュウ	ソウ
捥	ウチ	ウツ	ウデ	モ	モギ	ワン
捦	カタクト	キン	ゴン
捧	ササ	ササゲ	ホウ
捨	シャ	ス/ステ/ズ	ステ/ズテ
捩	スジ	ネ	ネジ	モジ	ヨジ	レイ	レツ
捫	ナ	モン
捬	ナ	フ	ホウ
捭	ハ	ハイ	ヘイ
据	キョ	ス/スエ
捱	ガイ	ゲ	フセ
捲	ケン	マ/マキ	マク	メク
捴	ソウ	フン
捵	チン	テン	ネン	ノ
捶	スイ/ズイ	ムチウ
捷	カツ	ショウ	ソウ	トシ	ハヤ
捸	トチ	トツ	ナメ
捺	オ	サ	ダツ	ナツ/ナッ
捻	ジョウ	ネ	ネジ	ネン	ヒネ
捼	オ	ダ	ダイ	ナ	ナイ
捽	サイ	ジュチ	スイ	ソチ	ソツ	チュツ	ツカ
捿	ス	セイ
掀	キン	ケン
掂	テン	ハカ
掃	カ	シュ	ソウ	ハ/ハキ
掄	エラ	リン	ロン
掇	セチ	セツ	タチ	タツ	テチ	テツ	ヒロ
授	サズ	サヅ	ジュ
掉	チョウ	トウ	フル
掊	カ	フウ	ブ	ホウ
掌	ショウ/ジョウ	タナゴコロ	ツカサド	テノヒラ
掎	キ	ヒ
掏	エラ	ス	トウ
掐	キョウ	コウ	ツマ
排	オシ	ハイ/バイ
掔	カタ	カン	ケン
掕	ト	リョウ
掖	エキ	タス	ワキバサ
掘	クツ/クッ	ホ/ホリ/ボ	ボリ
掙	サ	ショウ	ソウ
掚	カザ	リョウ
掛	カ/ガ	カイ	カカ	カカリ/ガカリ	カケ/カゲ/ガケ	ガカ	ケイ
掞	エン	セン	ノ
掟	オキテ	ジョウ	チョウ	テイ	トウ
掠	カス/カスリ	グラ	リャク	リョウ
採	サイ	ト/トリ
探	サガ	サグ	タン
掣	セイ	セツ	ヒ
掤	ヒョウ	フタ
接	ショウ	セツ/セッ	ツ/ツギ	ハ
掦	カカ	チャク	テキ
控	コウ	ヒカ/ビカ	ヒカエ/ビカエ
推	オ/オシ	スイ/ズイ	スス
掩	エン	オオ
措	オ	ソ
掫	ウ	シュウ	ソウ	タキギ	マモ
掬	キク	コク	スク/スクイ	タナゴコロ	ムス
掭	テン
掮	カツ	ケン
掯	コウ	トドコオ
掲	カカ	ケイ
掴	カク	ツカ/ヅカ	ツカミ	ヅカミ
掵	ハバ
掻	カ/カイ/カキ/カッ/ガ	カキ/ガキ	ソウ
掽	ツ	ハエズミ	ヒョウ	ホウ
掾	エン	ジョウ	テン
揀	エラ	カン	ケン
揁	キョウ	コウ	チョウ	テイ	ヒ
揃	キ	セン	ソロ/ゾロ	ソロイ	ゾロイ
揄	ユ	ユウ	ヨウ
揅	ケン	ミガ
揆	キ	ハカ	ハカリゴト
揈	ウ	キク	ケン	コウ
揉	ジュウ	モ/モミ/モメ
揎	カカ	セン
描	エガ	カ/ガ	ビョウ
提	サ/サゲ	ダイ	チョウ	ツツミ	テイ	ヒサゲ	ヒッサ
揑	ゲチ	ゲツ	コネア	ネツ
插	サ	ソウ	ハサ
揓	シ	ト
揔	ス	スス	スベ	ソウ	ヒキ	ミナ
揕	ウ	サ	チン
揖	イ	イツ/イッ	シュウ	ユ	ユウ
揚	ア/アガ/アゲ	アガリ	ヨウ
換	カ/カエ/ガ	カエ/ガエ	カン
揜	アン	エン	オン	ト
揠	アツ	サツ	ヌ	フダ
握	アク/アッ	ニギ
揣	シ	スイ	タン	ハカ
揥	コウガイ	タイ	チャク	テイ	テキ
揩	カイ	カツ	ヌグ
揪	アツ	シュ	シュウ
揬	コス	ツ	トツ	ドチ	フ
揮	キ	フル
揲	カゾ	ジョウ	セツ	ゼチ	チョウ
揳	カツ	ケチ	ケツ	セチ	セツ	タダ
援	エン
揵	ア	ケン	ゴン
揶	カラカ	ヤ
揸	サ	ツマ
揹	セオ	ハイ
揺	ウゴ	ユ/ユス/ユラ/ユル	ヨウ
搆	コウ
搉	ウ	カク
搊	シュ	シュウ	ス
損	ソコ/ゾコ	ソコナ	ソン/ゾン
搏	ウ	ト	ハク
搐	イタ	チク
搒	オオ	ヒョウ	ホウ
搓	サ	サイ	ヨ
搔	カ	ソウ
搖	ウゴ	ユ	ヨウ
搗	カ	ツ/ツキ	ツキ/ヅキ	トウ
搘	ササ	シ
搜	サガ	シュ	シュウ	ソウ
搞	キョウ	コウ	タタ
搠	サク	ヌ
搢	サイ	シン	セイ	セン	ハサ
搤	アク	エチ	エツ	セク	トラ
搥	ズイ	タイ	ツイ	ナゲウ
搦	カラ/カラミ/カラメ/ガラ	カラミ/ガラミ	ジャク	ジョク	ダク	ニャク
搨	ウ	ス	トウ
搩	カツ	ケツ	ゲチ	タク	チャク	テデモノヲハカ
搪	トウ	ハ
搬	ハン/パン
搭	トウ
搯	トウ	トリダ
搰	コツ	ホ
搴	ケン	ト	ヌ
搵	オサ	オン	シズ
搶	ショウ	ソウ	ツ
携	ケイ	タズサ
搽	タ
搾	サク	シ	シボ
搿	カク
摂	オサ	カネ	ショウ	セツ/セッ	ト
摋	ウ	サチ	サツ	セチ	セツ
摎	キュウ	ク
摏	シュ	ショウ	ツ
摑	カク	ツカ
摒	ハラ	ヒョウ	ヘイ
摓	ヌ	フウ	ブ	ホウ
摔	シュチ	シュツ
摘	ツ/ツマ/ツミ	ツム	テキ
摚	チョウ	ト	トウ
摛	シク	チ	ノ	リ
摜	カン	ナラ
摝	ウゴカ	ル	ロウ	ロク
摟	ヒ	ル	ロウ
摠	ス	ソウ	フサ
摡	アラ	カイ	キ	ケ
摣	サ	サイ	シャ	セ	ダ	ツカ	ト	ナ
摧	クダ	サ	サイ
摩	サス	ス/ズ	マ
摭	シャク	セキ	ヒロ
摯	イタ	シ
摳	ウ	オウ	ク	コウ	ヒロ
摴	チ	チョ	ノ
摶	セン	タン	マル
摸	バク	ボ	マク	モ	モウ
摺	シュウ	ショウ	ス/スリ/ズ	スル/ズル	ズリ	ヒダ	ロウ
摻	サン	シン	セン	ト
摽	ウ	ヒョウ	ホウ
撃	ウ/ウチ	ゲキ
撅	アツ	カチ	ケ	ケイ	ケツ
撇	ヌグ	ヘイ	ヘチ	ヘツ
撈	リョウ	ロウ
撏	サン	シン	ト
撐	ア	ササ	チョウ	トウ
撑	ア	ササ	チョウ	トウ
撒	サツ/サッ	サン	マ/マキ
撓	イタ/イタメ	キョウ	コウ	シオ	シナ	シワ	ジョウ	タワ	トウ	ミダ
撕	シ	セイ
撘	トウ
撙	オサ	ソン
撚	ネン	ヒネ	ヨ	ヨリ
撛	タス	ヌ	リン
撝	イ	キ	ハナ
撞	シュ	ツ/ツキ	トウ/ドウ
撟	キョウ	コウ
撡	アヤツ	サン	ソウ	ミサオ
撣	セン	タン	モ
撤	テツ/テッ
撥	オサ	ハ/ハネ/パ	ハツ/ハッ/パツ	バチ
撦	サ	シャ
撨	エラ	オ	ショウ	ス	ソウ	ト	ヌグ
撩	リョウ	ロウ
撫	ナ	ナデ	ナデシ	フ/ブ	ム
撬	ア	キョウ
播	ハ/パ	ハリ	ハン/バン/パン	マ/マキ
撮	ウツ	サツ	ツマ	ト/ド
撰	エラ	サン	セン
撲	ナグ	ボク
撳	オサ	キン
撹	カク	コウ	ミダ
撻	タツ	ムチウツ
撼	ウゴカ	カン
撽	キャク	キョウ	ケキ	コウ	タタ
撾	ウ	カ	タ	テ
撿	ケン	コマネ	レン
擁	ヨウ
擂	ス/スリ	ライ
擄	トリコ	リョ	ロ
擅	セン	ホシイママ
擇	エラ	タク
擉	サ	サク	ショク	ゾク	タク
擊	ウ	ゲキ
擋	サ	トウ
擌	サク	チャク	モチザオ
操	アヤツ	サオ	サン	ソウ	ミサ	ミサオ
擎	ギョウ	ケイ	ササ
擐	カン	ケン	セン	ツラヌ
擑	ショウ	セツ	ツ
擒	キン	トラ	トリコ
擔	カツ	タン	ニナ
擕	ケイ	タズサ
擗	ハク	ヒャク	ヘキ	ムネヲウ
擘	サ	ハク	ヒャク	ヘキ
據	キョ	コ	ヨ
擠	オ	サイ	セイ
擡	タイ	モタ
擢	タク	テキ	ヌ	ヌキ
擣	ウ	ツ	トウ
擤	カ	キョウ	コウ
擥	ト	ラン
擦	コス	サツ/サッ	ス/スリ/スレ/ズ	ズリ	ズレ	ナス
擧	ア	キョ	コゾ
擩	ジュ	ズイ	ニ	ニュ	ヒタ
擪	エン	オウ	オサ	ジョウ	チョウ	ニョウ	モ	ヨウ
擬	ギ	ナゾラ	マガ	モド
擭	ア	キョ	ワク
擯	シリゾ	ヒン
擰	ドウ	ニョウ	ミダ
擱	オ	カク
擲	ジャク	チャク	テキ	ナグ	ナゲウ
擴	カク	コウ	ヒロ
擵	サ	ス	マ
擶	セン	タダス
擷	ケツ	ツマバサ	ハサ
擺	ハイ	ヒラ
擻	ア	ス	ソウ
擽	ウ	クスグ	フキ	ラク	リャク	レキ
擾	ジョウ	ミダ	ワズラ
擿	カ	ジャク	チャク	テキ
攀	ハン	ヨ
攁	ヒラキウゴカ	ヨウ
攄	チョ	ノ
攅	アツ	サン
攈	キン	クン	ト	ヒ	ヒロ
攉	カク
攊	ウ	クス	ラク	リャク	レキ
攏	ト	ル	ロウ
攓	ケン	ト
攔	サエギ	ラン
攖	エイ	セム	ヨウ
攘	ジョウ	ヌス	ハラ
攙	サ	サン	シン	セン
攛	サン	ナゲウ
攜	ケイ	タズサ
攝	オサ	カネ	ショウ	セツ/セッ	ト
攞	エラ	サ	ラ
攟	キン	クン	ト	ヒ	ヒロ
攢	アツ	サン
攣	ツ	ヒ	レン
攤	タン	ヒラ
攦	オ	シ	ネジ	ライ	リ	レイ
攩	オウ	コウ	タタ	タモ	トウ	トモ
攪	カク	コウ	ミダ
攫	カク	サラ	ツカ
攬	ト	ラン
攮	オ	ドウ	ヌ
支	カ	ササ/ササエ/ザサ	シ/ジ	シンヨウ	ジュウマタ	ツカ
攱	キ	コシカ	ノ	マクラ
攴	トマタ	ホク/ボク	ボクヅクリ	ボクニョウ
攵	ノブン	ホク	ボクヅクリ	ボクニョウ
收	オサ	オサム	シュウ
攷	カンガ	コウ
攸	トコロ	ユウ
改	アラタ	アラタメ	カイ/ガイ
攺	イ	シ
攻	オサム	コウ	セ/セメ/ゼ
攼	エ	カン	ト	モト
攽	ハン	ヒン	ワ
放	コ	ッパナ	ハナ/ハナシ/ハナツ/バナ	ハナレ	パナ	ピ	ホ	ホウ/ポウ	ホカ
政	ショウ/ジョウ	セイ	タダ	マサ	マサシ	マツリゴト	マン
敃	ツト	ビン	フン	ミン
故	コ/ゴ	フル	モト	ユエ
敇	サク	シャク	ムチウ
效	キ	キキメ	コウ	ナラ
敉	ナ	ヒ	ミ
敍	ジョ	ツイ	ツイデ
敏	サト	サトイ	サトシ	ザト	チョウ	トシ	ハヤ	ビ	ビン
敐	シン/ジン	ヨロコンデウゴ
救	キュウ	スク	タス
敒	オサ	ショウ	シン	チン	ノ
敔	ギョ	ゴ	サシト
敕	イマシ	チョク	ミコトノリ
敖	アソ	オゴ	ゴウ
敗	ハイ/バイ/パイ	マ	ヤブ
敘	ジョ	ツイ	ツイデ
教	オシ/オシエ	オソ	キョウ/ギョウ	ノリ	ヒサ
敝	ヘイ	ヤブ
敞	ショウ	タカ	タカシ	ヒロ	ホガ
敟	ツカサド	ツネ	テン
敠	セチ	セツ	タチ	タツ	ハカ
敢	ア	アエ	カン/ガン
散	サン/ザン	チ/チリ/ヂ	チリ/ヂリ	チル	バラ
敦	アツ	アツシ	タイ	ダン	チョウ	ツル	トン	ノブ	ノリ
敧	キ	ハサ
敫	ウツ	キャク	キョウ	ケキ	セク	ヤク
敬	ウヤマ	キョウ	ケ	ケイ	タカ	タカシ	タケ	トシ	ノリ	ヒロ	ユキ	ヨシ
数	カズ	カゾ	サク/サッ	シバシバ	シュ/ジュ	ス/ズ	スウ/ズウ	セ	ソク	ワズラワ
敲	コウ	タタ	ノボル
整	セイ	トトノ	ヒトシ
敵	アダ	カタキ/ガタキ	カナ	テキ
敷	シ/ジ	シキ/ジキ	ニュウ	フ
數	カズ	カゾ	サク	シバシバ	シュ	ス	スウ	セ	ソク	ワズラワ
敺	カ	ク
敽	キョウ	ツナ
斁	イヤ	エキ	ズ	セク	ト
斂	オサ	レン
斃	タオ	ヘイ
斅	ガク	マナ
文	アヤ	カザリ	フ/ブ	フミ/ブミ	ブン	モ	モン
斈	ガク	マナ
斉	アタル	サイ/ザイ	セイ	ソロ	タダ	ナリ	ハヤイ	ヒト	ヒトシ
斊	ア	サイ	セイ	ソロ	ハヤ	ヒト
斌	アキ	アキラ	ウルワ	タケ	タケシ	ヒン	フン
斎	イ/イミ	イツ	イツキ	イワ	キヨ	サイ	サエ	タダ	ツツシ	トキ	ヒトシ	モノイミ	ヨシ
斐	アヤ	イ	ヒ/ビ
斑	イ	ハン	フ	ブチ	マダラ	ムラ
斒	ハン	ヘン	マダラ
斕	アヤ	ラン	レン
斗	ト/ド	トウ	マス
斘	ショウ	ショク	ノボ
料	リョウ
斛	コク	ト
斜	シャ	ナナ	ハス
斝	ウツワ	カ	ケ
斟	ク	シン
斠	カク	キョウ	コウ	ハカ
斡	アツ/アッ	カン	メグ	ワツ
斣	カエア	クラ	シュク	ショク	ソク	ツ	トウ	ハカ
斤	オノ	キン
斥	シリゾ	セキ
斦	アキ	ギン	ゴン	シチ	シツ
斧	オノ	フ
斫	キ	シャク	ハツ
斬	キ/キリ/ギ	ギリ	サン/ザン	セン/ゼン
断	コト	コトワ	サダ	タ/タチ/ダ	ダン
斮	キ	サク	シャク
斯	カ	コウ	ココニ	コノ	コレ	シ
新	アセ	アタラ	アタラシ	アラ	アライ	アラタ	サラ	シ	シムラ	シン/ジン	ニ	ニイ	ニツ/ニッ	ヨシ
斲	キ	キュウ	タク
斳	キン	コン	セリ
斴	リン
斷	コトワ	サダ	タ	ダン
方	カタ/ガタ	カラ	ナ	ナタ	フサ	ホウ/ボウ/ポウ	マサ	ミチ	モ	ワ
於	アア	オ	オイ	ヨ	ヨリ
施	シ	セ	ホドコ
斿	ハタアシ	ユウ	ヨ	ヨウ	リュウ	ル
旁	カタガタ	カタワラ	ツクリ	ホウ/ボウ
旂	キ	ゲ	ハタ
旃	セン	ハタ
旄	ボウ	モウ
旅	タビ	リョ
旆	ハイ	ハタ
旈	ハタアシ	リュウ
旉	シ	シキ	ニュウ	フ
旋	セン
旌	アラ	ショウ	セイ	ハタ
旎	ジ	タナビ	ダ	ニ
族	ゾク	ツギ	ヤカラ
旐	ジョウ	チョウ
旒	ハタアシ	リュウ
旔	カツ	ケン	コン
旖	イ	ナビ
旗	キ	ハタ/バタ
旘	シ	ノボリ
旙	ハタ	ハン	ヘン
旛	ハタ	ハン/バン	バ	ヘン
旟	ア	ハタ	ヨ
无	ナイ	ナシ	ブ	ム	ムニョウ
旡	キ	ケ	スデノツクリ	ナシ	ム
既	キ	スデ	スンデ
日	ア	アキ	イル	カ/ガ	ク	クサ	コウ	ジツ	ス	タチ	ニ	ニチ	ニツ/ニッ	ヒ/ビ/ピ	ヘ
旦	アキ	アキラ	アサ	アシタ	タダシ	タン/ダン
旧	キュウ	フ	フル	モト
旨	ウマ	シ/ジ	ムネ
早	サ	サカ	サッ	サワ	ソ	ソウ/ゾウ	ハヤ/バヤ	ワ
旬	シュン/ジュン
旭	アキ	アキラ	アサヒ	キョク/キョッ	テル	ヒ
旰	カン	ク
旱	カン	ヒデリ
旲	エイ	オオ	タイ	ヒカゲ
旴	アサ	ク
旵	タン	テン
旹	ジ	トキ
旺	ウツクシ	オウ	カガヤ	キョウ	ゴウ	サカン
旻	アキゾラ	ビン	ミン
旾	シュン	ハ
旿	アキ	ゴ
昀	イン
昂	ア	アキ	アキラ	コウ/ゴウ	タカ/タカブ	タカシ	ノボル
昃	カタム	ショク	ソク
昄	オオ	ハン	ヘン
昆	コン
昇	シュウ	ショウ	ノボ/ノボリ/ノボル	ノリ
昈	アキ	コ
昉	アキ	ホウ
昊	コウ	ソラ	ヒロシ
昌	アキ	アキラ	アツ	サカエ	サカン	ショウ/ジョウ	スケ	マサ	マサシ	マサル	ヨシ
昍	アキ	カン	ケン
明	ア/アカシ/アク	アカ/アカラ/アカリ	アカリ/アガリ	アキ	アキラ	アケ/アゲ	アス	キラ/ギラ	ケ	サヤ	サヤカ	トシ	ハル	ミ	ミョウ	ミン	メ	メイ
昏	ク	クラ	クレ	コン
昑	アキ	キン
昒	コチ	コツ	ブツ	モチ	ヨア
易	イ	エキ	ヤサ	ヤス
昔	シャク/ジャク	セキ	ムカシ
昕	アサ	キ	キン	コン
昖	エン	メグ
昜	ヨウ
昝	サン
昞	アキ	ヒョウ	ヘイ	ホウ
星	ショウ/ジョウ	セイ	ホシ/ボシ
映	アキラ	ウツ	エ	エイ	テル	ハ/バ	ハユ/バユ
昡	ケン
昢	ハイ	ハチ	ホツ	ヨア
昣	アキ	シン
昤	リョウ	レイ
春	アズマ	カス	シュン	スノ	ハル/バル/パル	ヒ	ワラ
昦	コウ	ソラ
昧	クラ	バイ	マイ	ムサボ
昨	サク/サッ
昩	クモ	バツ	ホシ	マチ
昪	アキ	タノ	ヘン
昫	アタタ	キョウ	ク
昬	ク	クラ	コン
昭	アキ	アキラ	カズ	カズミ	ショウ/ジョウ	テル
昮	ショウ	ジュ
是	コ	ココ	コノ	コレ	シ	スナオ	ゼ	タダシ	ツナ	ユキ	ヨシ
昰	コレ	シ	ゼ
昱	アキ	イク
昳	イツ	カタム	テツ	デチ
昴	コウ	スバル	ボウ
昵	ショク	ジツ/ジッ	チカヅ
昶	アキラ	チョウ
昷	オン	メグ
昹	アイ
昼	チュウ	ヒル/ビル/ピル
昿	アキラカ	コウ	ムナ
晀	アキ	チョウ
晁	アキラ	アサ	チョウ
時	ジ	ト/ド	トキ/ドキ	トギ
晃	アキ	アキラ	アキラカ	コウ	テル	ヒカル	ミツ
晄	アキラ	アキラカ	コウ
晅	アキ	カン	ケン
晆	カイ	ワカ
晉	シン	スス
晊	オオ	シチ	シツ
晋	クニ	シン	スス	ススミ	ススム	ノブ	ユキ
晌	ショウ	マヒル
晎	アケカ	ク	コウ
晏	アン	オソ
晑	アキ	キョウ	コウ
晒	サイ	サラ/ザラ	サラシ	ザラシ	シ
晗	カン	ゴン
晘	カン	ゲン
晙	アキ	シュン
晛	ケン	デン	ネン	ヒガアラワ	ヒザ
晜	アニ	コン
晝	チュウ	ヒル
晞	カワ	キ
晟	アキラ	アキラカ	ジョウ	セイ
晠	アキ	ジョウ	セイ
晡	フ	ホ	ユウガタ
晢	アキラカ	セイ	セツ
晤	アキラカ	ゴ
晦	カイ	クラ	ツゴモリ	ミソ	ミソカ	モリ
晧	コウ
晨	アサ	アシタ	シン	トキ
晩	オク	バン
晪	アキ	テン
晫	アキ	タク
晬	サイ	スイ	ヒトマワリ
普	アマネ	アマネシ	シン	ヒロ	ヒロシ	フ/ブ
景	カゲ	ケイ/ゲイ
晰	アキラカ	シャク	セキ
晳	アキ	シャク	セキ
晴	セイ	ハ/ハラ/バ	ハル	ハレ/バレ	バラ
晵	ケイ	ケン	ハ
晶	ア	アキ	アキラ	ショウ	ヒカリ	マサ
晷	カゲ	キ
晸	チョウ	テイ
晹	エキ	カゲ	シャク	セキ	セク
智	アキラ	サト	サトイ	サトシ	サトル	ジ	チ	トシ	トミ	トモ	ノリ	ヒト	モト	ヨモ
晻	アン	エン	オン	クラ
晼	エン	オン
晾	サラス	リョウ
晿	ショウ
暀	ウツクシ	オウ	カガヤ	キョウ	ゴウ	サカン
暁	アカツキ	アキ	アキラ	アケ	キョウ/ギョウ	サト	サトル	テル
暃	ヒ
暄	アタタカ	ケン
暇	イトマ	カ	ヒマ
暈	ウン	カサ	クマ	ボ	ボカ	ボカシ	メマイ
暉	アキラ	カガ	キ	テル
暋	コン	ツト	ビン
暌	ク	ケ	ケイ
暍	アチ	アツ	アツサアタリ	エツ	オチ
暎	ウツ	エイ	ハ	ヨウ
暐	イ	ヒザシ
暑	アツ	ショ
暒	セイ	ハ
暖	アタタ	ダン	ノン
暗	アン	クラ/グラ	クレ
暘	ヨウ
暙	シュン
暚	アキ	ヒノヒカリ	ヨウ
暛	アキ	サ
暜	アマネ	フ
暝	クラ	ミョウ	メイ
暟	カイ	テライ
暠	コウ
暢	イタル	チョウ	トウル	トオル	ナガ	ノビ	ノブ	ノブル	ノリ	マサ	ミツル	ヨウ
暤	アキ	コウ
暦	コヨミ/ゴヨミ	リャク	レキ
暫	ザン	シバ	シバラ
暭	アキ	コウ
暮	ク/クラ/クレ/グ	グラ	グラシ	グレ	ボ	ポ
暱	ジツ	チカヅ	ニチ
暲	ショウ
暴	アバ	バク	ボウ
暵	カワ	カン
暸	アキラカ	リョウ
暹	セン
暻	アキ	キョウ	ケイ
暼	ヘチ	ヘツ/ベツ
暾	アサヒ	トン
暿	アツ	キ
曀	イ	エイ	クモ
曁	オヨ	キ
曂	アキ	オウ	コウ
曃	アキラカデナイ	タイ
曄	アキ	カガ	ヨウ
曇	クモ/グモ	クモリ	グモリ	ズミ	ド	ドン
曈	ツ	トウ	ホノグラ
曉	アカツキ	アキ	キョウ/ギョウ	サト	サトル
曌	ショウ	テ
曎	エキ	ヒカ	ヤク
曏	キョウ	コウ	サキニ	ショウ
曔	アキ	カワ	ギョウ	ケイ
曖	アイ	クラ
曙	アケボノ	ショ
曚	クラ	ボウ	モウ
曛	クン	タソガレ
曜	テル	ヨウ
曝	サラ/ザラ	バク/バッ	ホク/ボク
曟	アサ	アシタ	シン	トキ
曠	アキラカ	コウ	ムナ
曦	キ/ギ
曨	オボロ	ル	ロウ
曩	サキ	ドウ	ノウ
曫	タソガレ	バン	マン	ラン	レン
曬	サイ	サラ	サラシ	シ
曮	ガン	ゲン	ゴン
曰	イワ	イワク	エツ	ココニ	ノタマ	ヒラビ
曲	キョク/キョッ/ギョク	クセ	クマ	マ/マガ/マゲ	マガ/マガリ	マガタ
曳	エイ	ヒ/ヒク	ヒキ/ビキ
更	コウ	サラ/ザラ	フ/フカ/フケ	フケ/ブケ
曵	エイ	ヒ	ビキ
曷	イズクンゾ	イツ	カツ	ナニ	ナンゾ
書	カ/カイ/ガ	カキ/ガキ	ショ/ジョ	フミ
曹	ソウ/ゾウ
曺	ソウ	ツカサ	トモガラ	ヘヤ
曻	ショウ	ノボ
曼	ナガ	バン	マン
曽	カツ	カツテ	スナワチ	ソ	ソウ/ゾウ	ゾ
曾	カ	カツ	スナワチ	ソ/ゾ	ソウ/ゾウ
替	カ/カワ/ガ	カエ/ガエ	カワ/ガワ	タイ
最	サイ	シュ	ツマ	モ	モット
會	ア	アイ	アツ	エ	カイ
朅	ケチ	ケツ	コチ	サル
朇	オギナ	タス	ヒ	マス
月	オト	ガツ/ガッ	ゲツ/ゲッ	ス	ズキ	ツキ/ヅキ	モリ
有	ア	アラ	アリ	アル	ウ	クニ	タモツ	ナオ	ユ	ユウ
朋	トモ	ホウ
服	ハツ/ハッ	ハラ	フク/ブク/プク
朎	ツキノウツクシイヒカリ	リョウ	レイ
朏	ハイ	ヒ	ミカヅキ
朓	チョウ
朔	サク	タチ	ツイタチ
朕	チン
朖	アキ	ホガ	ロウ
朗	アキ	アキラ	オ	サエ	ホガ	ロ	ロウ
朙	ア	アカ	アキ	ミョウ	ミン	メイ
望	ノゾ	ノゾミ	ノゾム	ボウ	ミ	モ	モウ	モチ
朜	ツキノヒカリ	トン
朝	ア	アサ/アザ	アソ	ササ	チカ	チョウ	トモ
朞	キ	ゴ
期	キ	ゴ
朠	エイ	ヨウ
朢	ボウ	モウ	モチヅキ
朦	オボロ	ボウ	モウ
朧	オボ	オボロ	ロウ
木	キ	ギ	グ	コ/ゴ	ボク/ボッ	モ	モク/モッ	モト
未	イマ	ヒツジ	ビ	マ	ミ
末	スエ/ズエ	バツ/バッ	マツ/マッ
本	オ	ゴウ	ホン/ボン/ポン	マト	モト
札	サツ/サッ	サネ	フダ
朮	ウケラ	オケラ	シュツ/ジュツ	チュツ	モチアワ
朱	ア	アカ	アキ	アケ	シュ/ジュ	ス
朳	エブリ	ハチ	ハツ
朴	エノキ	ホウ/ボウ	ホオ	ボク
朶	エダ	タ/ダ	ヘゴ
朷	トウ
朸	オウゴ	オオゴ	リョク
机	キ/ギ	ツクエ/ヅクエ
朽	キュウ	ク/クチ	クツ
朾	ジョウ	チョウ	ツ	テイ	トウ
朿	シ	トゲ
杁	イリ	エブリ
杅	ウ	ユノミ
杆	カン	テコ
杇	ウ	オ	コ	コテ	ヌ
杈	エダ	サ	サイ	シャ
杉	サン	スキ	スギ
杌	キリカブ	グチ	グツ	ゴチ	ゴツ
李	イ	スモモ	モモ	リ
杏	アン	アンズ	カラモモ	キョウ	コウ	スモモ	リョウ
材	キ	サイ/ザイ
村	エ	ソン	ムタ	ムラ	ラ
杓	シャク/ジャク	チョウ	テキ	ヒシャク	ヒョウ
杔	ウツギ	サケコシ	タク	チャク
杕	タ	ダイ	テイ
杖	ジョウ	ツエ/ヅエ
杙	クイ/グイ	クイゼ	ヨク
杜	ズ	ト	トウ	フサ	モリ	ヤマナシ
杝	イ	シ	チ	マガキ
杞	キ	コ
束	ソク/ゾク	タバ	ツカ/ヅカ
杠	コウ	チギリ	テコ	ユズリハ
条	エダ	ジョウ	スジ	チョウ	デキ
杢	モク
杣	ソマ
杤	トチ
来	キ/ギ	キタ/キダ	ク/グ	クリ/グリ	クル/グル	コ/ゴ	ゴロ	サ	タイ	ライ
杦	スギ
杪	コズエ	ショウ	ビョウ
杬	ガン	ゲン	フジモドキ
杭	クイ/グイ	コウ	ワタル
杮	コケラ	ハイ
杯	サカズキ	ハイ/バイ/パイ
杰	ケツ	ゲチ	スグ
東	アイ	アガリ	アキラ	アズマ	アヅマ	コ	サキ	シノ	トウ/ドウ	トオ	ハル	ヒガ	ヒガシ	モト
杲	アキラカ	コウ	タカ
杳	クラ	ハルカ	ヨウ
杴	ケン	コン	スキ
杵	キ/ギ	キネ	ショ	ソ
杶	チュン
杷	ツカ	ハ/バ	ワ
杻	シュウ	チュ	チュウ	テカセ	ニュ
杼	ショ/ジョ	チョ	ドングリ	ヒ
松	オオ	ショ	ショウ/ジョウ	マ	マツ/マッ
板	イタ	ハン/バン/パン
极	キョウ	ゴウ	ニグラ
构	カマ	コウ
枅	ケイ	ヒジキ
枇	ヒ/ビ
枉	オウ	マ
枋	ヘイ	ホ	ホウ/ボウ
枌	ショウ	ソギ	フン	マツ
枎	シゲ	フ
枏	クス	クスノキ	ゼン	ダン	ナン	ネン
析	セキ
枑	コ	ヤライ
枓	シュ	ツ	トウ	ヒシャク
枕	シン	チン	マクラ
枖	ヨウ
林	シ	ハヤシ	バヤシ	リン
枘	セン	ゼイ	ドン	ネイ	ノン	ホゾ
枙	アク	ガ	フシ	ヤク
枚	バイ	ヒラ/ビラ	マイ
枛	キノトゲ	ショウ	ソウ
果	オオ	カ/ガ	ハ/ハテ	ハタ	ミ
枝	エ	エダ	グサ	シ/ジ
枠	ワク
枡	マス
枢	カラクリ	クルル	シュ	スウ	トボソ
枦	ハシ/ハジ	ハゼ	ロ
枩	ショウ	マツ
枯	カ/ガ	コ
枰	スゴロクバン	ビョウ	ヘイ
枱	イ	シ	スキ
枲	カラムシ	シ
枳	カラタチ	キ	シ
枴	カイ	ツエ
枵	ウツロ	キョウ
架	カ	カカ
枷	カ	カセ	カラザオ
枸	ク	コウ
枹	ナラノキ	バチ	フ	ホ	ホウ	モミジ
枻	エイ	カイ	セチ	セツ
枼	ウスイキフダ	マド	ヨウ
枽	クワ	ソウ	ヨウ
柀	カヤ	スギ	ヒ
柁	カジ	タ/ダ
柂	イ	カジ	タ	リ
柃	リョウ	レイ
柄	エ	カラ/ガラ	ツカ/ヅカ	ヘイ/ペイ	ラ
柅	ジ	ニ
柆	ロウ
柈	ハチ	ハン
柉	ハン	ヘン	ボン
柊	シュ	シュウ	ヒイラギ
柎	ウテナ	フ
柏	カイ/ガイ	カシ/ガシ	カシワ/ガシワ	カセ	カヤ/ガヤ	ハク/パク	ヒャク/ビャク
某	ソレガシ	ナニガシ	ボウ
柑	カン	コン
柒	ウルシ	シチ	シツ
染	シ/シミ/ジ	ジ/ジミ	セン/ゼン	ソ/ソマ/ゾ	ソメ/ゾメ
柔	ジュウ	トオ	ニュウ	ヤワ	ヤワラ
柗	ショウ	マツ
柘	シャ	ジャク	ソ	ツ	ツゲ	ヤマグワ
柙	オウ	オリ	コウ	ヨウ
柚	ジク	ユ	ユウ	ユズ
柜	アマダレ	キョ	ク	コ
柝	キ	タク	ヒョウシギ
柞	サク	ハハソ
柡	エイ	ヨウ
柢	テイ	ネ
柤	サ	ソ
柦	タン
柧	カ	ク	コ
柩	キュウ	グ	ヒチギ	ヒツギ
柬	エラ	カン	ケン
柮	トツ
柯	エ	カ	フル
柰	イカン	カラナシ	ダイ	ナ	ナイ
柱	チュウ	ハシラ/バシラ/パシラ
柲	ニギリ	ヒ	ヒツ	ビチ	フル
柳	ナギ	ヤ	ヤイ	ヤギ	ヤナ	ヤナイ	ヤナギ	リュウ
柴	サイ	シ	シバ
柵	サク	サン	シガラ	シガラミ	トリデ	マセ	ヤナ	ヤライ
柶	サジ	シ
柷	シュク
柹	カキ	コケラ	シ
査	サ/ザ
柾	マサ	マサキ	マサメ
柿	カキ/カギ/ガキ	シ
栂	ツガ	トガ
栃	トチ/ドチ
栄	エ	エイ	サカ/ザカ	サカエ	シゲ	シゲル	テル	ナガ	ハ/バ	ヒサシ	ヒデ	ヨウ	ヨシ
栓	セン
栔	キザ	ケイ	ケチ	ケツ
栖	ス/スム	スミ	セイ
栗	オノノク	クリ	クル/グル	グリ	リ	リツ/リッ
栙	コウ	フネノホ	マダハラヌホ
栝	カチ	カツ	タキギ	テン
栞	カン	シオリ
栟	ヒュウ	ヒン	ヘイ
校	キョウ/ギョウ	コウ	メン
栢	カシワ	カヤ	ハク	ヒャク
栧	エイ	カイ	セチ	セツ
栨	シ	セチ	セツ	タル	ハリ
栩	ク	クヌギ
株	カブ	シュ
栫	カコイ	セン	ソン
栬	セ	セイ	チイサナクイ
栭	ジ	ニ	マスガタ
栯	イク	ウ	ヨウ
栰	イカダ	ハツ	ボチ
栱	キョウ	ク	クイ
栲	カエ	コウ	タエ
栳	コウ	ロウ
栴	セイ	セン	モミジ
核	カク/カッ
根	コン/ゴン	ネ/ネザ
栻	シキ	ショク	チキ	チョク
格	イタル	カク/カッ	キャク	コウ/ゴウ	タダス	ノリ
栽	サイ
栿	ノ	ハリ	フク
桀	ケツ	ハリツケ	マス
桁	ケタ/ゲタ	コウ
桂	カ	カツ	カツラ/カヅラ	ケイ	ヨシ
桃	トウ	ミ	モノ	モモ
桄	コウ	ヨコギ
桅	ガイ	キ	クチナシ
框	カマチ/ガマチ	キョウ
案	アン	ツクエ
桊	ケン
桌	タク
桍	コ
桎	アシカセ	シツ/シッ
桐	キ	キリ/ギリ	トウ/ドウ	ヒサ
桑	クワ/グワ	コ	ソウ
桒	クワ	ソウ
桓	カン
桔	キ	キツ/キッ	ケツ
桕	キュウ	ブナ
桗	タ	ネ
桘	ウ	シイ	スイ	ツイ	ツチ
桙	ウ	ホコ
桛	カセ
桜	オウ	サ	サクラ/ザクラ	ヨウ	ロウ
桝	マス
桟	カケハシ	サ	サン/ザン	セン
档	トウ
桧	カイ	ヒ/ビ	ヒノキ
桫	サ	ヘゴ
桮	サカズキ	ハイ
桯	ギョウ	ケイ	チョウ	ツクエ	テイ
桰	カチ	カツ	ユダメ
桱	キョウ	ケイ
桲	カラザオ	ホツ	ボチ
桴	イカダ	バチ	フ
桵	ズイ	タラ	ニ
桶	オケ	トウ	ヨウ
桷	カク	タルキ
桹	ロウ
桺	ヤナギ	リュウ
桻	コズエ	フ	ホウ
桼	ウルシ	シツ
桾	クン
桿	カン	テコ
梁	ウチバリ	ウツバリ	ハシ	ハリ	ヤナ	リョウ
梂	キュウ	キョク	グ	コク	ノミノサキ
梃	チョウ	ツエ	テイ	テコ
梄	ヤ	ユ	ヨウ
梅	ウメ	バイ
梆	ホウ
梈	キデツクツタオオユミ	ヒョウ	ホウ
梍	ユウ
梏	カク	コク	テカセ
梓	アズサ	アヅサ	シ
梔	クチナシ	シ
梖	ハイ/バイ
梗	オオムネ	キョウ	コウ	フサグ	ヤマニレ
梘	カン	ケン	セン
梚	バン	マン
梛	ダ	ナ	ナギ
梜	キョウ	コウ	ソエイタ
條	エダ	ジョウ	スジ	チョウ	デキ
梟	キョウ	フクロウ
梠	ヒサシ	リョ	ロ
梡	カン	コン	タキギ	マナイタ
梢	クスノキ	コズエ	ショウ
梣	シン	トネリコ
梥	ショウ	マツ
梦	クラ	ボウ	ム	ユメ
梧	アオギリ	ゴ
梨	カ	ナシ	リ
梩	シ	スキ	リ
梪	ズ	タカツキ	トウ
梭	サ	ヒ
梮	カンジキ	キク	キョク	コク	ゼン
梯	カケハシ	タイ/ダイ	テイ	ハシゴ
械	カイ	カセ
梱	コ	コウ	コウリ	コリ	コン	シキミ
梲	セチ	セツ	タチ	タツ	ツカ
梳	クシケズ	ケズ	ス	ソ	ト
梵	フウ	ボン
梶	カジ	コズエ	ビ
梹	ヒン
梺	フムト	フモト
梻	シキミ
梼	トウ	ユス
棄	キ	ス
棅	ヒョウ	ヘイ
棆	リン
棈	ショウ	セイ	セン
棉	メン	ワタ
棊	キ/ギ	ゴ
棋	キ/ギ	ゴ
棌	アラキ	クヌギ	サイ	マルキ
棍	コン	ツエ
棏	タク	チャク	トク
棐	ヒ	ユダメ
棑	イカダ	ハイ	ヒ
棒	ササゲ	ボウ
棓	ツエ	フミイタ	ホウ
棔	コン	ネムノキ
棕	シュ	ソウ
棖	ジョウ	トウ	ハシラ
棗	ソウ	ナツメ
棘	イバラ	オドロ	キョク	トゲ
棙	カラクリ	ネジ	ネジキル	ライ	レイ	レチ	レツ
棚	タナ/ダナ	タノ	ホウ
棜	オ	ダイ	ヨ
棝	ク	コ	ネズミオトシ
棟	トウ	ムナ	ムネ
棠	トウ/ドウ	ヤマナシ
棡	コウ
棣	タイ	テイ	ニワザクラ
棥	ハン	ボン	マガキ
棧	カケハシ	サン	セン
棨	ケイ	ケン	テガタ
棪	エン	セン
棫	イキ	イク	クヌギ	タラ	ヨク
棬	カン	ケン
棭	エキ	ネムノキ	ヨク
森	シン	モト	モリ
棯	ネン
棰	スイ	ソイ	タ	ツエ
棱	チョウ	リョウ	ロウ
棲	ス/スミ	ズミ	セイ
棵	カ	カン	キギレ
棶	ムク	ライ
棹	コ	サオ/ザオ	タク	トウ
棺	カン	ヒツギ
棻	フン
棼	フン	ムナギ
棽	シン	チン	リン
椀	ハチ	ワン
椁	カク
椄	ショウ	セツ	ツ
椅	イ
椆	シュ	シュウ	チュウ
椈	キク
椉	ショウ	ノ
椊	サツ	スイ	ソツ	ホゾ
椋	グラ	ムク	リョウ
椌	コウ
植	ウ/ウエツ	ウエ	エ	ゲ	ショク
椎	ウ	シイ/ジイ	スイ	ツイ	ツチ
椏	マタ
椐	キョ	コ	マガキ
椑	タル	バイ	フダ	ヘイ
椒	ショウ	ハジカミ
椓	タク	タタ
椖	ホウ
椗	イカリ	テイ
椙	スギ
椚	クヌギ
椛	カバ	モミジ
検	アラタ	ケン	シラ
椡	クヌギ
椢	カイ	クヌギ	ソコ	ハコ
椣	シデ
椥	ナギ
椦	ケン	マゲモノ
椨	タフ	タブ
椪	ポン
椰	ヤ	ヤシ
椱	イノアシ	フウ	フク	ブ
椳	ガイ	ワイ
椴	タン/ダン	トド	トドマツ	ムクゲ
椵	カ	クイ	ケ
椶	シュ	ソウ
椸	イ	コロモカケ
椹	アテギ	クワノミ	サワラ	シン/ジン	チン
椻	エン	セキ
椽	エン	タルキ	テン
椿	チュン	チン	ツバ	ツバキ
楂	イカダ	サ	ジャ
楅	ヒキ	ヒュク	ヒョク	フク
楉	ザクロ	ジャク	ニャク
楊	ヤナ	ヤナギ	ヨウ
楎	カラ	キ	クン	コン	スキ
楓	カエデ	フウ
楔	クサビ	ケツ	セツ/セッ	ホウダテ
楕	タ/ダ
楗	カンヌキ	ケン	ゴン
楙	シゲル	ボウ
楚	イバラ	シモト	ショ	スワエ	ソ
楛	コ
楜	クルミ	コ
楝	オウチ	オオチ	レン
楞	カド	リョウ	ロウ
楠	クス/グス	クスノキ	クズ	ゼン	ダン	ナ	ナン	ネン
楡	ニレ	ユ
楢	シュウ	ナラ	ユウ
楣	ヒサシ	ビ	ミ
楤	ソウ	タラ
楥	エン	カタ	カン	ケン
楦	ケン
楨	チョウ	テイ	ネズミモチ
楩	ヘン
楪	チャ	ユズリハ
楫	カイ	カジ	シュウ	ショウ
楬	ケツ	ゲチ	タテフダ
業	ギョウ	ゴウ	ナリ	ノブ	ワザ
楮	コウジ	コウズ	コウゾ	チョ
楯	ジュン	タテ/ダテ
楰	ギョ	ゴ	ネズミモチ	ユ
楱	ス	ソウ
楲	イ	オカワ	オマ	トイ
楳	ウメ	バイ
楴	テイ
極	キ/ギ	キマ/ギマ	キョク/キョッ	キワ/キワメ	キワミ	ゴク/ゴッ
楷	カイ
楸	キササゲ	シュウ	ヒサギ
楹	エイ	ハシラ
楺	ジュウ	ジョウ	ニュ
楻	オウ	コウ	ハタザオ
楼	タカドノ	ロウ
楽	ガク/ガッ	コノ	ゴウ	サ	タ	タノ	ヤス	ラ	ラク/ラッ
楾	ハンゾウ
楿	カツラ
榀	コマイ
榁	ムロ
概	オオム	ガイ
榊	サカキ/サガキ
榍	セツ
榎	エ	エノ	エノキ	カ
榑	クレ/グレ	フ
榒	ダク	ドク	ニャク
榔	ロウ
榕	アコウ	ヨウ
榖	ク	コウ	コウゾ	コク
榘	ク	ジョウギ
榛	シン	ハイ	ハシバミ	ハリ	ハル	ハン
榜	カジ	タテフダ	フダ	ホウ/ボウ
榠	ベイ
榡	キジ	ソ
榥	オウ	コウ	ツクエ
榦	カン	ミキ
榧	カヤ	ヒ
榨	サ	サイ	サク	シボリキ	シャ
榫	シュン	ホゾ
榭	シャ	ダイ
榮	エ	エイ	サカ	サカエ	ハ	ヨウ
榯	シ	タ
榱	スイ	タルキ
榲	オツ
榴	ザクロ	リュウ	リョウ	ル
榷	カク	キョウ	コウ	マルキバシ
榸	カレキノネ	クイ	タイ
榺	ショウ	ハタケノイシヲカツ
榻	コシカケ	シジ	トウ
榼	コウ	サカズキ	サカダ
榾	コツ	ホタ
榿	カイ/ガイ
槁	カ	ケヤキ	コウ
槃	タラ	ハン
槅	アミド	カク	キャク	クビキ	サネ
槇	コズエ	シン	テン	マキ/マギ
槈	クサギ	クワ	ジュク	ジョク	スキ	ドウ	ヌ
槊	サク	ホコ
構	カマ/カマイ/ガマ	カマエ/ガマエ	コウ	トチ
槌	ツイ	ツチ/ヅチ
槍	ウツ	ショウ	ソウ	ヤリ
槎	イカダ	キ	サ
槐	エンジ	エンジュ	カイ	サイカチ
槑	ウメ	バイ
槓	コウ	テコ
槖	タク	フイゴ	フクロ
槗	キョウ	ハシ
様	サマ/ザマ	サン	ショウ	ヨウ
槙	コズエ	シン	テン	マキ/マギ
槝	カシ
槞	ロウ
槢	クサビ	シュウ	ジョウ	チョウ
槥	エ	エイ	セイ	ヒツギ
槧	サン/ザン	セン	フダ
槨	カク
槫	セン	タン
槭	カエデ	シュク	セキ
槮	サン	シン	セン
槯	サイ	セ	ツ
槱	ヤ	ユ	ユウ
槲	カシワ	コク
槳	カジ	ショウ	ソウ
槵	カン	ム
槹	コウ
槻	キ	ケヤキ	ツキ
槽	ソウ	フネ/ブネ
槾	コテ	バン	マン
槿	キン	ムクゲ
樀	タク	チャク	テキ	ノキ
樁	クイ	シュ	ショウ	トウ
樂	ガク	コノ	ゴウ	タノ	ラク
樃	ロウ
樅	ショウ	モミ
樊	ハン	マガキ
樋	テ	ト/ド	トイ/ドイ	トウ	トヨ/ドヨ	トワ	ヒ/ビ/ピ
樌	カン	ヌキ
樏	カンジキ	ハチ	ル	ルイ
樑	ウチバリ	ウツバリ	ハシ	ハリ	ヤナ	リョウ
樒	シキミ	ジンコウ	ミツ
樓	タカドノ	ロウ
樔	ス	スク	ソウ	タ
樕	シバ	ソク
樗	オウチ	オオチ	チョ	チョウ	ブナ
標	シベ	シメギ	シル	シルシ/ジルシ	シルベ	ヒョウ/ビョウ/ピョウ
樚	トク	ハコ	ロク	ロクロ
樛	キュウ	ツガ	マト
樝	コボケ	サ	シャ
樞	カラクリ	シュ	スウ	トボソ
樟	クス/クズ	クスノキ	クヌギ	ショウ
樠	バン	ボン	マン	モン
模	カタギ	カタド	ガミ	ボ	モ
樢	チョウ	ツタ	ト
樣	サマ	ショウ	ヨウ
樤	コエダ	ジョウ	ユズ
樨	サイ	セイ	モクセイ
権	オモリ	カリ	ケン/ゲン	ゴン	ハカ
横	オウ	ヨコ
樫	カシ/ガシ
樮	ホクソ
樰	タラ
樲	ジ	チ	ナツメ	ニ
樴	シキ	ショク	ボウ
樵	キコ	キコリ	コ	ショウ
樶	サイ	フシ
樷	クサムラ	ス	ソウ	ムラ
樸	キジ	コハダ	シラキ	ハク	ホク/ボク
樹	イツキ	ウエ	キ/ギ	コ	シゲ	ジ	ジュ	タチキ	タツ	タツキ	タツル	ナ	ミキ
樺	カ	カバ	カモ	カラ	カン	カンバ
樻	キ
樽	ソン	タル/ダル
樾	エツ	オチ	コカゲ
樿	セン	ツゲ
橄	カン
橅	カタ	ブナ	ボ	モ
橆	シゲ	ブ	ム
橇	カンジキ	キョウ	セイ/ゼイ	ソリ/ゾリ
橈	カイ	カジ	ジョウ	タワ	ドウ	ニョウ
橉	シキミ	リン
橊	ザクロ	リュウ	リョウ	ル
橋	キョウ	ハシ/バシ/パシ	バセ
橎	ハン	ボン
橐	シャ	タク	フイゴ	フクロ
橑	タルキ	ロウ
橒	ウン	モクメ
橕	チョウ	トウ	ハシラ
橖	クルマギ	チョウ	トウ
橘	キツ/キッ	タチバナ
橙	ダイダイ	トウ
橛	カチ	クイ	ケ	ケイ	ケツ
機	キ	ハタ/バタ
橡	クヌギ	ショウ	ゾウ	トチ
橢	ダ
橤	ズイ	タ	ニ
橦	シュ	ショウ	トウ
橧	ショウ	スマイ	ソウ
橪	エン	コナツメ	ゼン	ネン
橱	クリヤ	シュウ	ズ	チュ	チュウ
橲	キ	ジサ	ヨシ
橳	クデ	ヌデ
橸	マサ
橾	シュ	ス	ソウ
橿	カシ	キョウ	モチノキ
檀	タン/ダン	マユミ
檁	ケタ	リン
檃	イン	オン	タメギ
檄	ケキ/ゲキ	フレブミ
檆	サン	スギ
檇	サイ	スイ	ツ
檉	カワラヤナギ	チョウ	テイ
檋	カンジキ	キョウ	キョク	コク
檍	イ	オク
檎	キン	ゴ	ゴン
檐	エン	タン	ノキ	ヒサシ
檑	ライ
檗	キハダ	キワダ	ハク/バク	ビャク
檛	タ	ツエ	テ
檜	カイ	ヒ/ビ	ヒノキ
檝	カイ	カジ	シュウ	ショウ
檞	カイ	カシワ	ゲ	マツヤニ
檟	カ	ケ	ヒサギ
檠	ケイ	ユダメ
檢	ケン	シラ
檣	ショウ	ホバシラ
檥	ガ	ギ
檪	イチ	クヌギ	ヤク	レキ	ロウ
檫	サツ	シンバシラ
檬	モウ
檮	シ	トウ
檯	タイ	ツクエ
檰	トチユウ	ヘン	メン
檱	キ	ゴ	ゴイシ
檳	ヒン/ビン
檴	アキニレ	カク	ワク
檸	ドウ	ネイ
檻	オバシマ	オリ	カン	テスリ
檽	キクラゲ	ジ	ジュ	ゼン	ニ	ニュ	ネン
檾	イチビ	キョウ	ケイ
檿	エン	ヤマグワ
櫁	シキミ	ジンコウ	ミツ
櫂	カイ	カジ	タク	トウ
櫃	キ	ヒツ/ビツ
櫆	カイ
櫈	コシカ	トウ
櫉	チュ	ヒツ
櫌	ウ	ナ	ユウ
櫐	フジ	ライ	ルイ
櫑	サカダル	ライ
櫓	オオダテ	ヤグラ	ロ
櫔	レイ
櫕	サン	ツエ
櫖	フザ	リョ	ロ
櫚	リョ	ロ
櫛	クシ/クジ/グシ	クシケズ	シツ/シッ
櫜	コウ	フクロ
櫝	トク	ハコ	ヒツギ
櫞	エン
櫟	イチ	イチイ	クヌギ	ヤク	レキ	ロウ
櫤	セン	タモ
櫧	カシ	ショ	ソ
櫨	ハゼ	ロ
櫪	カイバオケ	クヌギ	レキ
櫬	カン	シン	ヒツギ
櫰	イヌエンジュ	エ	カイ
櫱	ガチ	ガツ	ゲチ	ゲツ	ヒコバエ
櫲	クスノキ	ヨ
櫺	リョウ	レイ	レンジ
櫻	オウ	サクラ	ヨウ
櫼	クサビ	サン	シン	セン
櫽	イン	オン	タメギ
欂	ハク	ハシラ	ビャク	ヘキ
欃	サン	セン
欄	テスリ	ラン
欅	キョ	ケヤキ
欆	ソウ	フネノホ
欇	ショウ
欉	シゲ	ス	ソウ
權	オモリ	カリ	ケン	ゴン	ハカ
欏	ヤマナシ	ラ
欐	ムネ	ライ	リ	レイ
欑	サン	ツエ
欒	オウチ	ヒジキ	マドカ	マルイ	ラン
欖	ラン
欗	テスリ	ラン
欛	ツカ	ハ	ヘ
欝	ウツ/ウッ	ウン	シゲ	フサ
欞	リョウ	レイ	レンジ
欟	ツキ
欠	アクビ	カ/カキ/カケ/ガ	カキ/ガキ	ガケ	ケツ/ケッ	ケン
次	キ	シ/ジ	スキ/スギ	ツ	ツギ	ツグ	ヨシ
欣	キン	コン/ゴン	シ	ヤスシ	ヨシ	ヨロコ
欤	カ	ヤ	ヨ
欧	ウタ	オウ	オオ	ハ	ヒロ
欨	ク	フク
欫	キャク	ケキ
欬	カイ	キ	セキ
欯	カイ	キチ	キツ	ヨロコ
欲	ホ/ホシ	ホッ	ヨク/ヨッ
欵	カン
欶	サク	シュク	ス	スク
欷	キ	ナゲク
欸	アイ	カイ
欹	イ	キ	ソバダ
欺	アザム	ギ
欻	クチ	クツ
欽	キン	コン	ツツシ	ヒトシ	ヨシ
款	カン/ガン	マサ
欿	カン	コン	タン	トン	モト
歃	コウ	ショウ	スス	ソウ
歆	ウ	キン	コン
歇	カイ	カツ	ケツ	ヤ
歉	アキタリナイ	カン	ケン
歊	カク	キョウ	コク	ノボ
歌	ウタ	カ/ガ
歍	ウ	オ	オウ	ハ
歎	タン	ナゲ
歐	ウタ	オウ	ハ
歒	チャク	テキ	ワラ
歓	カン	ブ	ヨロコ
歔	キョ	ススリナ
歖	イ	キ
歘	クチ	クツ
歙	キュウ	キョウ	ショウ	ス
歛	レン
歝	イヤ	エキ	ズ	ト	ヤク
歟	カ	ヤ	ヨ
歠	セチ	セツ	ノ
歡	カン	ヨロコ
止	サ	シ	ト/トマ/トメ/ド	トド	ドマ	ドメ	ヤ	ヨ
正	オオ	クニ	ショウ/ジョウ	セイ	タダ	タダシ	マ	マサ	マサシ
此	ココ	コノ	コレ	シ
武	イサム	ウ	オ	タカシ	タケ/ダケ	タケシ	タケル	タケン	ブ	ム	ン
歧	キ	ユビ	ワカ
歩	ア	アユ	アユミ	アユム	アル	フ/ブ	ホ/ボ/ポ	ユキ	ユミ
歪	イガ	イビツ	エ	ヒズ	ヒズミ	ユガ	ユガミ	ワイ
歫	キョ	ゴ	ト
歮	シブ	シュウ
歯	シ	ハ/バ/パ	ヨワ	ヨワイ
歰	シブ	シュウ	ソウ
歳	サイ/ザイ	セイ/ゼイ	トシ	トセ	ヨワイ
歴	ヘ	レキ	レッキ
歵	サク	ジャク	タダ	トトノ	ヨイ
歸	オク	カエ	キ	トツ
歹	イチタヘン	ガチ	ガツ	ガツヘン	シニガマエ	タイ
死	シ/ジ	シニ	ジニ
歽	セチ	セツ	ワカジ
歾	シ	ボツ
歿	シヌ	ボツ
殀	ヨウ	ワカジニ
殂	シ	ソ
殃	オウ	ヨウ	ワザワイ
殄	タ	ツキ	ツク	テン
殅	ショウ	ソウ	ヨミガ
殆	アヤウイ	サイ	タイ	ホト	ホトホト	ホトン
殉	ジュン
殊	コト	シュ/ジュ
残	サン/ザン	ソコナ	ノコ/ノコリ
殍	ウエジニ	ヒョウ	フ
殕	ネ	フ
殖	ウエ	エ	ゲ	ショク	フ
殗	エン	オウ	ヤ	ヨウ
殘	ザン	ソコナ	ノコ
殛	キョク	コク	コロ
殞	イン	ウン	オチ	シ
殟	オチ	オツ	オン	ラツ
殠	キュウ	ク	シュ	シュウ	ニオ
殢	ケイ	タイ	ツカ	テイ
殣	ウエジ	キン
殤	ショウ	ワカジニ
殨	エ	カイ	コツ	ゴチ	タダ
殩	サン
殪	エイ	タオ
殫	タン	ツキ
殬	ツ	ト	ヤブ
殭	カタ	キョウ	コウ
殮	オサ	レン
殯	カリモガリ	ヒン
殰	トク	ヤブ
殱	セン	ツク	ホロボ
殲	セン	ツク	ホロボ
殳	シュ	ホコ	ホコツクリ	マタ	ルマタ
殴	オウ	ナグ
段	タン/ダン
殷	アン	イン	サカン
殸	キョウ	ケイ	コウ	コエ	ショウ	セイ	テキ
殹	ウチアタルコエ	エイ	ミニクイスガタ
殺	アヤ	コロ/ゴロ	コロシ	サイ	サツ/サッ	セツ/セッ	ソ	トバ	ヤ
殻	カク	カラ/ガラ	コク	バイ
殼	カク	カラ	コク	バイ
殽	ギョウ	コウ	マ
殾	キズク	シュン
殿	シンガリ	テ	テン/デン	トノ/ドノ	ドン
毀	キ	コボ	コワ	ソシ	ヤブ
毃	カク	キョウ	タタ
毄	ア	キュク	ギキ	ケイ	ケキ
毅	アツシ	キ/ギ	コワシ	タカシ	タケ	タケシ	ツヨ	ツヨシ	トシ	ハタス	ミ
毆	オウ	ク	タタ	ナグ
毉	イ	エイ
毋	カンノハハ	ナイ	ナカ	ナカレ	ハハ	ブ	ボ	ム
毌	カン	ツラヌ	ナカレ	ハハ
母	ハハ	ボ	モ
毎	ゴト	ツネ	マイ
毒	ドク/ドッ
毓	イク	ソダ	ハグク	リュウ
比	イ	クラ	クラベ	タグ	ヒ/ビ/ピ	ピッ	フィリピン
毖	ツツシ	ヒ
毘	タス	ヒ/ビ/ピ
毚	ウサギ	サン	ゼン
毛	ケ/ゲ	メン	モ	モウ
毟	ムシ
毡	セン
毣	バク	ボク	マク	モク	ヨイ
毦	ケカザリ	ジ	ニ
毧	シュ	ジュウ	ニュ
毫	コウ/ゴウ	スコシ
毬	イガ	カサ	キュウ	マリ
毮	ムシ
毯	タン
毱	ケマリ
毳	ケバ	セイ/ゼイ	セツ	ムクゲ
毷	ト	ボウ	モウ
毹	ケムシロ	シュ	ス	ユ
毿	ケガナガイ	サン
氂	ボウ	モウ	ライ	リ
氄	ジュウ	ジョク	ニュ	ムクゲ
氅	カザリケ	ショウ
氈	セン	モウセン
氉	ケ	ソウ
氍	キョ	ク	ゴ	モウセン
氎	ジョウ	チョウ	モメンノヌノ
氏	ウジ	シ/ジ
氐	シ	タイ	チ	テイ	フモト
民	タミ	ヒト	ミ	ミン
氒	カチ	ケツ	ネ
氓	タミ	ボウ
气	イキ	キ	キガマエ	ケ
気	イキ	キ/キガ/ギ	ケ/ケオ/ゲ
氙	セン
氛	フン
氟	フツ
氣	イキ	キ	ケ
氤	イン
氦	ガイ
氧	ヨウ
氨	アン
氬	ア
氮	タン
氳	ウン	サカン
水	ウズ	スイ/ズイ	ズミ	ツ	ド	ミ	ミサ/ミザ	ミズ/ミズガ	ミズノ	ミツ/ミッ/ミヅ	ミナ	ミン
氵	サンズイ	ミズ
氶	ショウ	スク
氷	コオ	コオリ/ゴオリ	スイ	ヒ/ピ	ヒョウ/ピョウ
永	エ	エイ	ト	ナガ	ノリ	ヒサ	ヒサシ
氺	シタミズ	スイ
氻	ロク
氾	ハン	ヒロ
氿	オズミ	キ	キュウ	グ	ワキミズ
汀	テ	テイ	ナギサ	ミギワ
汁	シル/ジル	ジュウ	ツユ
求	キュウ/ギュウ	グ	ト	モト/モトム/モトメ
汊	サ	シャ
汋	ウルオ	サク	シャク
汍	カン
汎	タダヨ	ハン	ヒロ	ヒロシ	フウ	ブ	ホウ	ホン	ミナ
汏	アラ	タイ/ダイ	タチ	タツ
汐	イソ	ウシオ	シオ	セイ	セキ
汒	アワタダ	ボウ	モウ
汔	キツ	コチ
汕	サン
汗	アセ	カン/ガン
汙	オ	キタナ	ケガ	ヨゴ
汚	オ	キタナ/ギタナ	ケガ	ヨゴ
汛	サン	シャ	シン	ソソ
汜	イ	カワ	シ
汝	イ	イマシ	ウヌ	シ	シャ	ジョ	ナ	ナムチ	ナレ	ナンジ	マシ	ミマシ
汞	コウ	ミズガネ
江	エ	クン	コウ/ゴウ	トウミ	ミ	リエ
池	イ	イケ	チ
汢	ネタ
汧	キョウ	キヨ	ケイ	ケン	サワ	タダヨ
汨	イツ	コツ	シズ	ベキ
汪	オウ	ヒロ	ヒロシ
汫	キョウ	ケイ	ジョウ	セイ
汭	ゼイ	ゼツ	ナガ	ネイ	ネチ	ミギワ
汯	オウ	コウ
汰	オゴ	タ	タイ	ニゴ	ユ/ユリ	ヨナ
汲	キュウ	ク	クミ/グミ
汳	ヘン/ベン
汴	ヘン
汶	ブン	モン
汸	ツナ	ホウ
汹	キョウ	ワ
決	キ/キマ/キメ/ギ	キマ/ギマ	ケツ/ケッ	サ
汻	ク	コ	ホトリ
汽	キ/ギ
汾	フン
沁	シ	シン
沂	キ/ギ	ギン
沃	オク	ソソ	ヨウ	ヨク
沅	ゲン	ミナモト
沆	コウ	ヒロ
沇	イ	エン	ナガ
沈	シズ	シン/ジン	チン
沉	シズ	ジン	チン
沌	クラ	トン
沍	コ/ゴ	コオ	サ	ヒ
沐	アラ	モク/モッ
沒	オボ	シズ	ナイ	ボツ	モツ
沓	クツ/グツ	トウ
沔	ビン	ベン	ミン	メン
沕	カス	コチ	コツ	ブツ	モチ
沖	オキ	オキツ	チュウ	ワク
沗	ソ	テン	モ
沘	ヒ
沙	イサゴ	サ/ザ	シャ	スナ	ヨナゲル
沚	シ	ナギサ
沛	ハイ/バイ
沜	ハン
沟	ク	コウ
没	オボ	シズ	ナイ	ボツ/ボッ	モツ/モッ
沢	ウルオ	オモ	サ/ザ	サワ/ザワ	サワン	タク/ダク	ツヤ	ワサ
沫	アワ	シブキ	ツバキ	バツ	マツ
沮	ショ	ソ	ハバ
沰	タク	ナ
沱	タ/ダ
沲	タ
河	カ/ガ	カッ	カワ/ガワ	コ/ゴ	コウ/ゴウ
沴	ソコナ	テン	ライ	レイ
沸	ニエ	フツ/フッ/ブツ	ワ/ワカ/ワキ
油	アブラ	ユ	ユウ
沺	デン
治	オサ	オサム	シ/ジ	チ/ヂ	ナオ	ハリ/バリ	ハル/バル	ミチ
沼	ショウ	トウ	ヌマ
沽	アタ	アラ	ウ	コ
沾	ウルオ	セン	チョウ	テン	ヌ	ヌレ
沿	エン	ソ/ソウ/ゾ
況	イワ	イワン	オモムキ	キョウ	マ	マシ
泂	ギョウ	ケイ	サム
泄	エイ	セツ	モ
泅	オヨグ	シュウ
泆	アフ	イチ	イツ	テツ	デチ
泉	イズ	イズミ	イヅミ	シミズ	ズイ	ズミ	セン/ゼン	ゼイ	ノ
泊	ト/トマ/ド	トマ/ドマ	トマリ/ドマリ	ハク/ハッ/パク	ハツ
泌	ヒ/ピ	ヒツ/ピツ
泍	ホン
泏	コチ	コツ	チュツ
泐	フミ	リョク
泑	クロ	ユ	ユウ
泒	ク	コ
泓	オウ	フカ
泔	カン	ゴン	ユス
法	ノット	ノリ	ハッ	フラン	ホ/ボ	ホウ/ボウ/ポウ	ホッ/ボッ
泖	ボウ	ミョウ	ラ	リュウ
泗	シ	ナミダ
泙	ホウ
泚	キヨ	サイ	シ	セイ
泛	ウカ	ハン	ホウ
泜	シ	タイ	テイ
泝	サカノボル	ソ
泠	サト	リョウ	レイ	レン
泡	アワ	ホウ/ポウ
波	ナミ	ハ/バ/パ	ヒラ	ミナ	ミナミ	ワ
泣	キュウ	ナ/ナカセ/ナキ
泥	デ	デイ	ドロ	ナイ	ナズ	ニ	ヒジ
泧	エツ	オチ	カチ	ケツ
注	サ/サシ	ソソ	チュウ	ツ
泩	ショウ	ソウ	ミナギ
泪	ナミダ	ルイ	レイ
泫	ケン/ゲン	ナガ
泬	ケチ	ケツ	ホトバシ
泮	ハン	ワカツ
泯	ビン	ベン	ホロ	ミン	メン
泰	タ	タイ	ハス	ヒロ	ヒロシ	ヤ	ヤス	ヤスシ	ユタカ	ヨシ
泱	オウ
泲	サイ	セイ
泳	エイ	オヨ
泴	カン	キヨ
洄	カイ	サカノ
洇	イン	エチ	エツ	シズ
洊	イタ	セン	ソン
洋	ナダ	ヒロ	ヒロシ	ヨ	ヨウ	ヨシ
洌	キヨ	キヨシ	レイ	レツ
洎	キ	ソソ
洏	ジ	ニ	ヌルマユ
洑	フク
洒	アラ	サイ	シャ	スス	セイ	セン	ソン
洓	サク	シ	シャク	セキ	ソボフ	ヒタ
洗	アラ	アライ	セン	ライ
洙	シュ/ジュ
洚	グ	コウ
洛	ラク
洞	トウ/ドウ	ホラ/ボラ
洟	イ	テイ	ハナ/バナ	ハナシル	ハナジル	パナ
津	シン	ズ	チ	ツ/ヅ	ト
洦	ハク	ヒャク	ミャク
洧	イ
洨	キョウ	コウ
洩	エイ	セツ	ノ	モ
洪	コウ	ヒロシ	ホン
洫	キョク	ミゾ
洮	アラ	トウ	ヨウ
洯	イサギヨ	ケツ
洱	ジ	ニ
洲	シマ/ジマ	シュウ	ス/ズ
洳	ジュ
洵	シュン/ジュン	ノ	マコト
洶	キョウ	ワ
洸	アキラ	コウ	タケシ	ヒカリ	ヒロ	ヒロシ
洹	エン	オン	カン
活	イ/イケ	カツ/カッ
洼	アイ	エ	ワ	ワイ
洽	アマネ	アマネシ	ウルオ	コウ	ヒロシ
派	ハ/バ/パ
洿	ウ	オ	コ
流	ナ	ナガ/ナガシ	ナガレ	ナガレバエ	メグル	リュウ	ル
浄	キヨ	キヨシ	ジョウ	セイ
浅	アサ	アザ	サ	セン
浗	キュウ	グ
浙	セツ/セッ
浚	サラ/サライ/ザラ	シュン
浜	ハマ/バマ/パマ	ヒン/ピン
浞	ウルオ	サク
浟	ウ	チャク	テキ	ユ	ユウ
浡	オコ	ホツ	ボチ
浣	アラ	カン
浤	コウ	フカ
浥	ウルオ	オウ	ユウ	ヨウ
浦	ウラ	ホ/ポ
浧	エイ	チョウ	テイ	ドロ	ヨウ
浩	オオキ	コウ	コオ	ヒロ	ヒロシ	ユタカ
浪	ナニ	ナミ	ロウ
浬	カイリ	ノット	リ
浮	ウ/ウカ/ウワ	ウキ	フ/ブ	ム
浯	ゴ
浰	ライ	リ	レイ	レン
浴	ア	エキ	サコ	ヨク/ヨッ
海	ア	アマ	ウナ	ウミ	ウン	エ	カ	カイ/ガイ	タ	トド	ヒロ	ヒロシ	ブ	マチ	ママ	ミ	メ	ワタ	ワタル
浸	シン	ツ	ヒタ/ビタ
浹	アマネシ	ショウ
浼	ケガ	バイ	バン	マイ	マン
涂	ジョ	ズ	チョ	ト	ミチ
涅	ソ	デツ	ネツ
涇	キョウ	ケイ	テイ	ミゾ
消	キ/キエ/ギ	ケ/ケシ/ゲ	ショウ
涌	ユ	ユウ	ヨウ	ワ/ワキ/ワク
涎	エン	セン/ゼン	ヨダレ
涑	シュ	シュウ	ス	スス	ソウ
涒	イン	キン	トン	ハ
涓	ケン
涔	サン	シン	セン	ヒタ
涕	テイ	ナ	ナミダ
涖	ノゾ	ライ	リ	レイ
涗	セイ	セチ	セツ	ヌルマユ
涘	シ	ホトリ
涙	ナミダ	ルイ	レイ
涛	ト	トウ	ナミ
涜	ケガ	トウ	トク	ミゾ
涪	フウ	ブ	ホウ
涬	ギョウ	ケイ
涯	ガイ	ハテ
液	エキ
涴	エン	オン	カ	ワ
涵	カン	ヒタ
涷	ツ	トウ	ニワカアメ
涸	カ/カラ/ガ	カク	カラ/ガラ	コ	コオ
涹	イ	ダイ	ニゴ	ネ	ヒタ	ワ
涼	ウス	サヤカ	スズ/スズミ	スズカ	ヒヤ	マコトニ	リョ	リョウ
涽	コン	ミダ
涿	タク	トク
淀	テン/デン	ヨド
淄	シ
淅	セキ
淆	コウ	マ
淇	キ
淈	コチ	コツ	ニゴ
淊	アン	エン	カン	ゴン
淋	サビ	サミ	リン
淌	トウ
淎	フ	ホ	ホウ
淏	コウ
淑	シト	シュク	スク	トシ	ヨシ
淒	サイ	サム	スゴ	スサ	セイ
淕	リク	ロク
淖	トウ	ドロ	ニョウ
淘	トウ	ヨナ
淙	ソウ
淛	セイ	セチ	セツ
淝	ヒ
淞	ショウ
淟	テン	トン	ニゴ
淠	ハイ	ヒ	ヘイ
淡	アワ	タン/ダン
淢	イキ	イチ	イツ	ハヤ	ヨク
淤	オ	ドロ	ヨ
淥	コ	リョク	ロク
淦	アカ	カン	コン
淨	キヨ	キヨシ	ジョウ	セイ
淩	ノ	リョウ
淪	シズ	リン	ロン
淫	イン	ヒタ	ホシイママ	ミダ	ミダリ
淬	サイ	ニラグ
淮	エ	カイ	ワイ
淯	イク
淰	アン	オン	ダン	デン	ニゴ	ネン
深	シン/ジン	フ/フケ/ブ	フカ/ブカ	フカシ	フケ/ブケ	ミ
淳	アツ	アツシ	キヨ	キヨシ	シュン/ジュン	スナオ	マコト
淴	オチ	オツ	コチ	コツ
淵	エン	カク	カタ	コウ	ハナワ	フカシ	フチ/ブチ/プチ
淶	ライ
混	コ/ゴ	コン	マ
淹	イ	エン
淺	アサ	セン
添	ソ/ソイ/ゾ	ソエ/ゾエ	ゾイ	テン	モ
淼	ヒロ	ビョウ	ミョウ
渀	ホン
渄	ヒ
清	アキ	キヨ	キヨシ	サヤ	シ	ショウ	シン	ス	スガ	スミ	セ	セイ	チン
渇	カ	カツ/カッ	カワ
済	サイ/ザイ	ス/スマ/スミ/ズ	スク	スム	ズミ	セイ/ゼイ	ナ	ナリ	ワタ	ワタシ	ワタル
渉	エン	ショウ	ワタ/ワタル
渊	エン	カク	カタ	コウ	ハナワ	フチ
渋	シブ	シュウ/ジュウ
渓	ケイ	タニ/ダニ	タニガワ
渕	エン	カク	カタ	コウ	ハナワ	フチ/ブチ
渙	アキラカ	カン	キヨシ
渚	ショ	ナギ	ナギサ	ミギワ
減	ゲン	ヘ/ベ	メ	メリ
渝	カワ	ユ
渞	シュ	シュウ	ミナモト
渟	テイ	トド	ヌ
渠	イズクンゾ	カレ	キョ	ダカリ	ナニ	ナンゾ	ミゾ
渡	オ	タリ	ト/ド	ワタ/ワタシ/ワタル/ワダ	ワタナ	ワタラ	ワタリ
渢	ハン	フウ	ブ
渣	サ
渤	ホツ/ボツ
渥	アク	アツ	アツシ	ウルオ
渦	ウズ	カ
渧	ダイ	チャク	テイ	テキ
温	アタタ	アツ	アツシ	オン	ナオ	ヌク	ヌル/ヌルミ	ハル	ユ	ユタカ
渫	サラ	セツ	チョウ
測	ソク/ソッ	ハカ
渭	イ
渮	カ
港	コウ	ミナト
渲	セン
渶	エイ	ヨウ
游	アソ	オヨ	ユウ	リュウ
渹	コウ	ショウ	セイ
渺	ビョウ
渻	ショウ	セイ
渼	ビ	ミ
渾	コン	スベ	ニゴ
湃	ハイ
湄	ダン	ナン	ビ	ミ	ミズギワ
湅	ネ	ラン	レン
湈	バイ	メ	ヤブ
湉	テン
湊	アツ	ソウ	ミナト
湋	イ	メグ
湍	タン	ハヤ	ハヤセ
湎	オボ	シズ	ベン	メン
湏	カイ	ケ	タダ
湑	キヨ	コ	シタミ	ショ
湒	シュ	シュウ	フ
湓	アフ	フン	ホン
湔	アラ	サン	セン
湖	ウミ	コ/ゴ	ミ	ミズウミ
湗	フ	フカイドロ	ホウ
湘	ショウ
湛	カン	キヨ	シズ	ジン	セン	タタ	タタウ	タタエ	タン	チン	ヤス
湜	キヨ	ショク	ジキ
湝	カイ	ナガ
湞	ジョウ	チョウ	テイ	トウ
湟	コウ
湢	ヒョク	ユドノ
湣	ビン	ベン	ミン	メン
湧	ユ	ユウ	ヨウ	ワ	ワキ	ワク
湨	キャク	ケキ
湫	クテ	シュウ	ショウ
湮	イン	エン	シズ	フサ
湯	トウ	ユ/ユガ
湲	エン	カン
湳	ダン	ナン
湶	イズミ	セン	ゼニ
湻	アツ	シュン
湽	シ
湾	イリエ	ワン
湿	ウルオ	シツ/シッ	シメ	シュウ
満	バン	マ	マン	ミ/ミチル	ミチ	ミツ	ミツル	ミノル
溂	ラツ
溌	ソソ	トビチ	ハツ/パツ	モ
溍	シン
溏	トウ
源	ゲン	ハジメ	ハラ	ミナ	ミナモト	モト
溓	カン	デン	ネバリツ	ネン	レン
準	ジュン	ナズラ	ナゾラ	ノリ	ヒト	ミズモリ
溘	コウ
溙	タイ
溜	シタタ	タ/ダ	タマ/ダマ	タマリ/ダマリ	タメ/ダメ	リュウ
溝	コウ	ドブ	ミゾ
溟	ウミ	クラ	メイ
溠	サ	シ	シャ
溢	アフ	イツ/イッ	コボ	ミ
溥	アマネシ	ハク	フ
溧	リチ	リツ
溪	ケイ	タニ/ダニ	タニガワ
溭	ショク	ジキ
溮	シ
溯	サカノボ	サク	ソ
溱	オオ	シン
溲	イバリ	シュ	シュウ	ソウ	ヒタ
溳	イン	ウン
溶	ト/トケ/ド	ヨウ
溷	カワヤ	ケガ	コン	ニゴ	ミダ
溺	イバリ	オボ	ジョウ	デキ	ニョウ
溻	ウルオ	トウ
溽	ジョク	ヒョク	ムシアツ
溿	ハン	ミズギワ
滀	アツ	チク
滁	ジョ	チョ
滂	ホウ/ボウ
滃	オ	オウ
滄	ソウ
滅	ホロ	メツ/メッ
滇	シン	テン
滈	カク	コウ	コク	ナガアメ
滉	コウ	ヒロ	ヒロシ
滊	キ	ケ	ケチ	ケツ
滋	シ/ジ	シゲ	シゲシ	シゲル
滌	アラ	ジョウ	テキ/デキ
滍	ジ	チ
滎	エイ	ギョウ	ケイ	チョロチョロ
滏	フ
滑	カツ/カッ	カリ	コツ/コッ	ス	スベ/スベリ	ナメ	ナメラ	ナメリ	ヌメ
滓	オリ	カス	サイ	シ
滔	トウ	ハビコ
滕	トウ	ワ
滝	ソウ	タキ/ダキ	ツダキ	ラキ	ロウ
滞	タイ	テイ	トドコオ
滫	シュ	シュウ	トギジル
滬	コ	コウ
滭	ヒチ	ヒツ	ワ
滮	ナガ	ヒュ	ヒュウ	ヒョウ
滯	タイ	テイ	トドコオ
滲	シ	シン	ニジ
滴	シズク	シタタ	テキ
滷	ロ
滸	コ	ホトリ
滹	ク	コ
滻	サン	セン
滽	ユ	ヨウ
滾	コン	タギ
滿	バン	マン	ミ	ミツル
漁	アサ	イサ	イザリ	ギョ	スナド	リョウ
漂	タダヨ	ヒョウ
漄	ガイ	ハテ
漆	ウル	ウルシ	シツ/シッ
漈	サイ	セイ	ミズギワ
漉	コ/コシ/ゴ	コシ/ゴシ	ス/スキ/ズ	ロク
漊	ル	ロウ
漌	キヨ	キン	コン	ヒタ
漍	カク
漏	モ	ロウ
漑	カイ/ガイ	ソソ
漓	ウス	リ
演	エン
漕	コ/コギ	ソウ	ハコ
漖	キョウ	コウ
漘	シン	ミズギワ
漚	ウ	オウ	ヒタ
漛	トウ	ナミ
漠	バク	ヒロシ
漢	カン	ハン
漣	サザナミ	ラン	レン
漦	ギ	シ	タイ	ナガ	ライ
漩	セン	メグ
漪	イ	ナミ
漫	ソゾ	マン	ミダリ
漬	シ	ツ/ヅ	ツケ	ヅケ
漭	ヒロ	ボウ	モウ
漯	トウ	ルイ
漰	ヒョウ	ホウ
漱	ウガイ	クチスス	クチソソ	シュウ	ス	スス	ソウ
漲	チョウ	ミナギ
漳	ササ	ショウ
漶	カン	ハッキリシナイ
漸	ウタテ	スス	ススム	ゼン	ヤヤ	ヨウヤ	ヨウヨ
漻	リュウ	リョウ	ル
漼	サイ	スイ	フカ
漾	タダヨ	ヨウ
漿	コンズ	ショウ
潁	エイ
潅	カン	ソソ
潏	ケチ	ケツ	シュツ	ジュチ
潑	ソソ	トビチ	ハツ	モ
潒	ショウ	ゾウ	タダヨ	トウ
潓	エ	ケイ
潔	イサギヨ	キヨ	キヨシ	ケツ/ケッ
潗	シュウ	ワ
潘	ハン
潙	イ	キ
潚	キヨ	シュウ	シュク	ショウ
潛	カク	クグ	セン	ヒソ	モグ
潜	カク	クグ	セン	ヒソ	モグ
潝	オウ	キュウ	コウ	ヨウ
潞	ル	ロ
潟	カタ/ガタ	ガラ	セキ
潡	オオミズ	トン
潢	イケ	オウ	コウ
潤	ウル	ウルウ	ウルオ	ジュン	ホト	メグミ
潦	ニワタズミ	ロウ
潨	アツ	キシ	シュ	ショウ	ズ	ソウ	ミズアイ
潬	ス	セン	タン
潭	ジン	タン	フカ	フチ
潮	イタ	ウシオ	シオ	チョウ
潯	ジン	フチ
潰	エ	カイ	ツイ	ツブ/ツブレ	ツブシ
潴	チョ
潸	サン
潺	サン	セン
潼	トウ/ドウ
潽	フ	ホ
潾	キヨ	ラン	リン	レン
澀	シブ	シュウ/ジュウ
澁	シブ	シュウ/ジュウ
澂	ス	スマ	チョウ
澃	キョウ	キヨ	ケイ
澄	キヨ	キヨシ	ス/スマ/スマシ/ズ	スス	スミ	チョウ	ミ
澆	ギョウ	ソソ
澇	オオナミ	ロウ
澈	キヨ	テツ	デチ
澋	ギョウ	ケイ	コウ	メグ
澌	サイ	シ	セイ	ツ
澍	ウルオ	シュ
澎	ヒョウ	ホウ
澐	ウン
澑	シタタ	タ	タマ	タマリ	タメ	リュウ
澒	ク	コウ
澓	フク
澔	オオキ	コウ	ヒロ
澖	カン	ゲン	ハテガナイ
澗	カン	ケン	タニ	タニミズ	マ
澚	イク	オウ	オキ	オク	クマ
澟	サム	リン
澠	ショウ	ビン	ミン
澡	アラ	ソウ
澣	アラ	カン
澤	ウルオ	サワ/ザワ	タク	ツヤ
澥	カイ	ゲ
澦	ヨ
澧	ライ	レイ
澨	エイ	セイ	ツキジ
澪	ミオ	レイ
澮	エ	カイ	ケ	ワイ
澯	キヨ	サン
澰	ナギサ	レン
澱	オリ	テン/デン	ド	ヨド
澳	イク	オウ	オキ	オク	クマ
澵	シン
澶	セン	テン
澹	アワ	セン	タン
澼	ケキ	タダヨ	ヒャク	ヘキ
激	ゲキ	タギ	ハゲ
濁	ジョク	ダク	ニゴ	ニゴリ
濂	レン
濃	コ/ゴ	コマ	ノ	ノウ
濅	ウルオ	シン	ヒタ
濆	フン	ホトリ	ホン	ワ
濇	シキ	シュウ	ショク	トドコオ
濈	シュウ	ジョウ	ソウ	ヤワ
濊	カイ	ケ	サイ	セ	ワイ
濔	ビ
濕	ウルオ	シツ	シメ	シュウ
濘	ヌカ	ネイ
濚	エイ	オガワ	ヨウ
濛	コサメ	モウ
濞	ハイ	ヒ	ヘイ
濟	サイ	ス	スク	セイ	ナ	ワタ
濠	コウ/ゴウ	ホリ/ボリ
濡	ウルオ	ジュ	ニュ	ヌ	ヌラ	ヌレ
濤	トウ	ナミ
濨	シ
濩	カク	ワク
濫	ミダ	ラン
濬	サラ	シュン
濮	ホク/ボク
濯	アラ	スス	ソソ	タク	ユス
濰	イ	ユイ
濱	ハマ	ヒン
濳	カク	クグ	セン	ヒソ	モグ
濵	ハマ	ヒン
濶	カツ	ヒロ
濹	ボク
濺	セン	ソソ
濼	ホク	ロク
濽	サン
濾	コ/コシ	リョ	ロ
瀀	アツ	ウ	ユウ
瀁	ヨウ
瀅	エイ	オガワ	キョウ	ケイ	ヨウ
瀆	ケガ	トウ	トク	ミゾ
瀇	オウ	コウ
瀉	クダ	シャ	ダカ	ハ
瀋	シン
瀍	テン
瀏	キヨ	リュウ
瀑	タキ	ニワカアメ	ハク/バク	ホウ/ボウ	ホク/ボク
瀕	ヒン	ホトリ
瀗	ケン	コン
瀘	ロ
瀚	カン	ナミ	ヒロ
瀛	ウミ	エイ
瀝	シタタ	レキ
瀞	キヨ	ショウ	ジュウ	セイ	トロ/ドロ
瀟	ショウ
瀠	エイ	ナガ	ヨウ
瀣	カイ	ミズ
瀦	ズマ	チョ
瀧	ソウ	タキ	ロウ
瀬	イワタ	ガセ	シゲ	セ/ゼ	セイ	セッ	セラ	ライ
瀯	エイ	オガワ	ヨウ
瀰	ビ	ミ
瀲	ナギサ	レン
瀴	エイ	フカ	ヨウ
瀷	イキ	シキ	ショク	ナガレ	ヨク
瀹	セク	ヒタ	ヤク	ヨウ
瀼	ジョウ	ドウ	ニョウ	ノウ
瀾	ナミ	ラン
灃	フ	フウ	ホウ
灄	ショウ	ニョウ
灈	ク
灉	ユ	ヨウ
灊	シン	セン
灋	ノリ	ハツ	フラン	ホウ	ホツ
灌	カン	ソソ
灎	エン	ナミ
灑	サ	サイ	シャ	セ	ソソ
灔	エン	ナミ
灕	シミコ	リ
灘	セ	タン/ダン	ダナ	ナダ	ナン
灝	カン	コウ	コン	マメ
灞	ハ/バ
灣	イリエ	ワン
灤	ナガ	ラン
灥	シュン	セン	タクサンノイズミ
火	カ/ガ	ヒ/ビ/ピ	ホ
灬	カ	ヒョウ	レッカ
灮	コウ	ヒカ	ヒカリ	ミツ
灯	アカ	アカシ	アカリ	トウ/ドウ	トボシ	トモ	トモシ	トモシビ	ヒ	ホ
灰	カイ	ハイ/バイ
灵	タマ	リョウ	レイ
灶	カマ	カマド	ソウ	ヘッツイ
灸	キュウ	ク	ヤイト
灼	アラタ	シャク	ヤ	ヤク
災	サイ	ワザワ	ワザワイ
灾	サイ	ワザワ
炁	イキ	キ	ケ
炅	アラワ	エイ	キョウ	ケイ	ヨウ
炆	アタタ	ブン	モン
炉	イロリ	ロ
炊	イ	カシ	スイ	タ/タキ/ダ
炎	エン	ヌク	ホノオ	ホムラ
炒	イ/イリ	イタ	ショウ	ソウ
炔	ケ	ケイ	ケチ	ケツ
炕	アブ	コウ
炖	トン
炗	コウ	ヒカ	ヒカリ
炘	アブ	キン	コン
炙	アブ	シャ	セキ
炛	キョウ	テ	ヨウ
炤	シャク	ショウ	テ
炫	ケン	ヒカ
炬	キョ	コ/ゴ	タイ
炭	スミ/ズミ	タン
炮	アブ	ホウ/ポウ
炯	アキラカ	カマ	キョウ	ケイ
炰	ビョウ	フ	フウ	ホウ
炱	スス	タイ
炳	アキラカ	ヘイ
炴	エイ	オウ	ヨウ
炷	シュ	トウシン
炸	サ	サク	タク
点	サ	タ/タテ	タテ/ダテ	ツ	テン	トボ	トモ	ボチ
為	イ	シ	ス	タメ/ダメ	タリ	ツク	ナ	ナリ	ビイ
烈	ハゲ	ヤス	レツ/レッ
烊	アブ	ヤ	ヨウ
烋	キュウ	キョウ	コウ
烏	イズクンゾ	ウ	オ	カラス/ガラス	ナンゾ
烑	ヒカ	ヨウ
烓	エ	エイ	カマド	キョウ	ケイ
烔	アツ	ズ	トウ
烕	ケチ	ケツ	ベツ	ホロ
烖	サイ	ワザワ
烘	アブ	カガリビ	キョウ	ク	コウ
烙	カク	ヤ	ラク
烜	カワ	カン	キ	ケン	テン
烝	ショウ/ジョウ	ム	モロモロ
烟	エン	ケブ	ケム	ケムリ
烤	アブ	コウ
烱	アキラカ	キョウ	ケイ
烹	ニ	ホウ/ポウ
烺	コウ	ヒ	ロウ
烽	トブヒ	ノロシ	ホウ
焃	アカ	カク	キャク	ケキ
焄	イブ	クン
焅	カワ	コウ	コク
焆	エチ	エツ	エン	ケン
焇	カワ	ケ	ショウ	ソウ	ト	トロ
焉	イズク	エン	ココニ	コレ
焋	ショウ	ソウ
焌	サン	シュン	ソン	ヤ
焏	キ	キョク	ケ	シバシバ	スミ
焔	エン	ホノオ	ホムラ
焙	アブ	アブリ	ハイ/バイ	ホウ
焚	タ/タキ	ハン	フン	ホン	ヤ	ヤキガリ
焜	カガヤ	コン
焞	アキ	タイ	ツイ	トン
焠	サイ	スイ	ヤ
無	ナ	ナイ	ナシ	ブ	ム
焦	アセ	コ/コガ/コガシ/コゲ	ショウ	ジ
焫	ゼツ	ネチ	ヤ
焭	ケイ	ヒトリモノ
焯	アキ	シャク	ショウ	タク	トク
焰	エン	ホノオ
焱	エン	キャク	ケキ	ホノオ
然	サ	シカ/ジカ	ゼン	ネン
焸	キョウ	ク	ケイ	コ
焼	ショウ	ヤ/ヤケ	ヤイ	ヤキ/ヤギ
煁	カマド	シン
煅	キタ	タン
煆	アツ	カ	ケ
煇	カン	キ	クン	ケン	ヒカリ
煉	ネ/ネリ	レン
煊	アタタ	カン	ケン
煋	アツ	ショウ	セイ
煌	カガヤ	キラ	キラメ	コウ
煎	イ	イリ	セン	ニ
煐	エイ	ヨウ
煒	イ	キ
煕	アキラカ	オキ	カワ	キ	タノシ	ヒカ	ヒロ	ヒロシ	ヨロコ
煖	アタタ	カン	ケン	ダン	ナン
煗	アタタ	ダン	ナン
煙	エン	ケム	ケムリ/ゲムリ	タバ
煚	キョウ	ケイ	ヒ
煜	イク	オウ	カガヤ
煞	コロ	サイ	サツ	セツ	ソ
煠	イタ	ジョウ	ソウ	チョウ	ヤ	ユ	ヨウ
煢	ケイ	ヒトリモノ
煤	スス	バイ	マイ
煥	アキラカ	カン
煦	アタタ	ク
照	アキ	アキラ	ショウ/ジョウ	テ/テラス/テリ/テレ/デ	テリ/デリ	テル
煨	ウズミビ	ウチ	ウツ	ワイ
煩	ウルサ	ハン	ボン	ワズラ
煬	アブ	ヤ	ヨウ
煮	シャ	ニ
煹	ク	コウ	ノロシ
煽	アオ	アフ	オコ	オダ	セン
熀	キョウ	コウ	サカン	ヨウ
熄	キ	ソク	ヤ
熅	イキ	ウズミビ	ウン	オン
熇	アツ	カク	コウ	コク
熈	アキラカ	カワ	キ	タノシ	ヒカ	ヒロ	ヨロコ
熊	クマ/グマ	ユウ
熌	セン	モエアガ
熏	イブ	クス	クユ	クン	フス
熒	ギョウ	ケイ	コウ	ヒカリ
熔	イガタ	ト	ヨウ
熕	オオヅツ
熙	アキラカ	カワ	キ	タノシ	ヒカ	ヒロ	ヨロコ
熚	ヒチ	ヒツ
熛	ヒョウ
熟	ウ	コナ	ジュク/ジュッ	ツクヅク	ナ/ナレ
熠	シュウ	ヒカリ	ユウ
熢	トブヒ	ノロシ	ホウ
熨	イ	ウツ	オサ	ノ	ノシ	ヒノシ
熬	イ	ゴウ
熯	カワク	ガン	ゼン	ネン
熰	ウ	オウ	マルヤキ
熱	アタ	アツ	イキ	ネツ/ネッ	ホテ
熲	キョウ	ケイ	ヒカリ
熳	マン	ミダ
熹	アカルイ	アキラ	アブ	キ
熺	アカ	アブ	キ
熾	オ/オキ	オコ	サカン	シ
熿	オウ	カガヤ	コウ
燀	セン	タク	タン
燁	オウ	サカン	ユウ	ヨウ
燃	ネン	モ/モエ
燄	エン	ホノオ
燈	アカリ	トウ/ドウ	トモ	トモシビ	ヒ	ホ
燉	トン
燋	シャク	ショウ	セキ	タイマツ
燌	タ	ハン	フン	ホン	ヤ	ヤキガリ
燎	カガリビ	リョウ
燐	キラメ	リン
燒	ショウ	ヤ	ヤキ
燓	タ	ハン	フン	ホン	ヤ	ヤキガリ
燔	ハン	ヤ
燕	エン	ツバクラ	ツバクロ	ツバメ
燖	シン	セン	ニ
燗	カン	ラン
燙	アタタ	トウ
燚	イチ	イツ
燜	モン
營	イトナ	エイ
燠	アタタカ	イク	ウ	オウ	オキ
燥	ソウ	ハシャ
燦	アキ	キラ	キラメ	サン
燧	スイ	ノロシ	ヒウチ	ヒキリ
燬	キ	ヤ
燭	ショク/ショッ	ソク	トモシビ
燮	ショウ
燵	タツ
燸	アタタ	ジュ	ダン	ニュ
燹	セン	ノビ
燻	イブ	イブシ	クス	クスブ	クユ	クン	フス
燼	ジン	モエノコリ
燾	ジュ	チュウ	テラス	トウ
燿	カガヤ	ヒカリ	ヨウ
爀	アカ	カガヤ	カク
爆	ハ	バク
爇	ゼイ	ゼツ	ネイ	ネチ	ネツ	ヤ
爈	ヤ	ヤマビ	リョ	ロ
爉	リョウ	ロウ
爍	シャク	トカ	ヒカ
爐	イロリ	ロ
爓	エン	セン	ヒカリ
爗	オウ	サカン	ユウ	ヨウ
爚	シャク	ヤク
爛	タダ	ラン
爝	サク	シャク	ショウ	タイマツ
爟	カン	ケン	ヤ
爤	タダ	ラン
爨	カシ	カマド	サン
爪	ソウ	ツマ	ツメ/ヅメ
爫	ツメカンムリ	ツメガシラ
爬	カ	ハ
爭	アラソ	イカ	ソウ
爯	ア	ショウ	トナエ
爰	エン	ココ
爲	イ	ス	タメ	タリ	ツク	ナ	ナリ
爴	カク	サラ	ツカ
爵	シャク
父	チチ	トウ	トッ	フ/ブ/プ
爸	ハ
爹	タ
爺	オヤジ	ジイ	ジジ	ジジイ	チチ	ヤ
爻	ギョウ	コウ	マジ	マジワル	メメ
爼	ショ	ソ	マナイタ
爽	アキ	サワ	ソウ	タガウ
爾	オレ	シカ	シカリ	ジ	ソノ	チカ	ナンジ	ニ	ノミ	ミ
爿	ショウ	ショウヘン	ソウ
牀	ショウ	ソウ	ユカ
牁	カ	クイ
牂	ソウ	メヒツジ
牃	オウチョウ	ショウ	チョウ	ユズリハ	ヨウ
牅	カキネ	ヨウ
牆	カキ/ガキ	ショウ
片	カタ/ガタ	ヒラ/ビラ	ヘン/ペン
版	ハン/バン/パン
牋	セン
牌	ハイ/パイ	ヒ	フダ
牎	ケムダシ	ス	ソウ	テンマド	マド
牏	シュ	チュ	ユ
牐	イタガコイ	ジョウ	ソウ
牒	ジョウ	チョウ	フダ
牓	カジ	タテフダ	フダ	ホウ
牕	ケムダシ	ス	ソウ	テンマド	マド
牖	マド	ユ	ユウ
牘	カキモノ	トク	フダ
牙	ガ	キバ	キバヘン	ゲ	ハ
牚	チョウ	トウ	ハシラ
牛	ウシ	ウジ	ギュウ	ゴ
牜	ウシヘン
牝	ヒン	メ	メス	メン
牞	キュウ	ク
牟	ボウ	ム
牠	タ
牡	オ	オス	オン	ボ	ボウ
牢	カタ	ヒトヤ	ロウ
牣	ジン	ニン	ミ
牧	ボク/ボッ	マ	マイ	マキ/マギ	モク
牨	オウシ	コウ	チン
物	ブツ/ブッ	モツ/モッ	モノ
牫	ウ	カ	キ	ソム	ハツ	ボチ
牮	セン	ツッポリ
牯	オウシ	ク	コ
牱	カ
牲	セイ
牴	テイ	フ
牷	イケニエ	セン
牸	シ	メ
特	トク/トッ/ドク
牻	ボウ	マダラ	モウ
牼	カン	キョウ	ケン	コウ
牽	ケン	ヒ/ヒキ
牾	ゴ
牿	オリ	コク
犀	サイ	セイ
犁	スキ	リ	リュウ	レイ
犂	カラスキ	スキ	リ	リュウ	レイ
犄	イ	キ
犇	ハシ	ヒシ	ヒシヒシ	ホン
犉	ジュン	ゼン	ニン	ネン
犍	ケン	コン
犎	フ	ホウ
犒	コウ	ネギラ
犓	シュ	ス	スウ
犖	マダラウシ	ラク
犛	カラウシ	ボウ	ミョウ	モウ	ヤ	リ
犠	イケニエ	キ/ギ
犢	コウシ	トク
犧	イケニエ	キ/ギ
犨	シュ	シュウ
犬	イヌ	ケン
犭	ケモノヘン
犮	ハツ	バチ
犯	オカ	ハン/パン	ボン
犱	キャク	ケキ
犲	サイ	ヤマイヌ
犴	カン
状	ジョウ
犹	ジョウ	ナオ	ユウ	ヨウ
犾	ギン
狁	イン
狂	キョウ	クル/クルイ/グル	クルオ	フ
狃	ジュウ	ナ	ナラ
狄	エビス	テキ
狆	チュウ	チン
狇	ボク
狉	コダヌキ	ヒ
狌	ショウ	セイ	ソウ
狎	アナド	オウ	コウ	ナ
狐	キツネ/ギツネ	コ
狒	ヒ	ヒヒ
狕	オウ	ヨウ
狖	ユ	ユウ
狗	イヌ	ク/グ	コウ
狘	カチ	ケツ
狙	ショ	ソ	ネラ
狛	コマ	ハク
狟	カン	ケン
狠	ガン	ゲン	コン	モト
狡	キョウ	コウ	コス	ズル	ワルガシコ
狢	カク	ハク/バク	ムジナ
狥	アマネ	シタガ	シュン	トナ
狩	カ/カル/ガ	カリ/ガリ	シュ
独	トク/トッ/ドク	ドイツ	ドッ	ヒト/ヒトリ
狭	キョウ	コウ	サ	セバ	セマ/ゼマ	ハザ
狳	ヨ
狴	ハイ	ヘイ
狷	ケン
狸	タヌキ/ダヌキ	ライ	リ
狹	キョウ	コウ	サ	セバ	セマ
狺	ギン	ゲン	ゴン
狻	サン	シュン
狼	オイ	オオカミ	ロウ
狽	ケン	ハイ/バイ
狾	ケイ	セイ
猂	アラシ	カン	タケシ
猄	キョウ	ケイ
猅	ハイ
猇	イカ	ウソブ	オウ	キョウ	コウ	シシ	タタ	ヨウ
猊	ゲイ
猋	ヒョウ
猍	タヌキ	ライ	リ
猒	ア	エン	オウ	ヨウ
猓	カ
猖	クル	ショウ
猗	ア	アア	イ
猘	ケイ	セイ
猙	ショウ	ソウ
猛	タカシ	タケ/ダケ	タケキ	タケシ	タケル	モウ
猜	サイ	ソネ
猝	ソツ	ニワカ
猞	シャ
猟	カ	カリ	リョウ	レフ
猢	コ
猤	イサ	キ	タケシイ
猥	ミダ	ミダリ	ワイ
猧	カ	チン	ワ
猨	エン	サル
猩	ショウ	ショウジョウ	セイ	ソウ
猪	イ	イノ	イノシシ	チョ
猫	ネコ	ビョウ
猬	イ	ハリネズミ
献	ケン	コン	タテマツ
猯	イノシシ	タン	マミ
猱	サル	ジュウ	ドウ	ニュウ	ノウ
猲	オオカミ	カチ	カツ	ケツ	リョウ
猴	コウ	サル
猵	ヒン	ヘン
猶	ナオ	ユ	ユウ
猷	ハカ	ハカリゴト	ユウ	ヨウ
猺	ヨウ
猻	サル	ソン
猽	ベイ	ミョウ	メイ
猾	カツ	ワルガシコ
猿	エン	サ	サル/ザル	サワ	マシ	マシラ
獃	オロ	ガイ
獄	ゴク/ゴッ	ヒトヤ
獅	シ/ジ	シシ
獍	カガミ	キョウ	ケイ
獎	ショウ	スス	ソウ
獏	バク	ミャク
獐	ショウ	ノロ
獒	イヌ	ゴウ
獖	フン	ホン
獗	ケツ
獘	ヘイ	ヘツ	ベチ
獝	イチ	イツ	キチ	キツ	クル
獞	ズ	トウ
獟	キョウ	ゴウ
獠	カリ	トウ	リョウ	ロウ
獣	ケダモノ	ケモノ	シシ	ジュウ
獦	オオカミ	カチ	カツ	ケツ	リョウ
獧	ケン	ハネオド
獨	トク/ドク	ドク/ドッ	ヒト
獩	エ	ワイ
獪	カイ	ワルガシコ
獫	ケン	レン
獬	カイ	ゲ
獮	カリ	セン
獯	クン
獰	ドウ	ネイ	ワル
獱	ヒン	ヘン
獲	エ	カク
獵	カ	カリ	リョウ	レフ
獷	アラ	キョウ	ク	コウ
獸	ケダモノ	ケモノ	ジュウ
獹	イヌ	ル	ロ
獺	ウソ	オソ	カワ	カワウソ	タツ/ダツ
獻	ケン	コン	タテマツ
獼	サル	ビ	ミ
玀	ラ
玁	ケン	レン
玃	オオザル	カク	キャク	ク	ケキ	ワク
玄	クロ	ケン/ゲン	ハル	ハルカ
玅	タエ	ビョウ	ミョウ
玆	ケン	ココニ	シ	シゲ	マス	ムシロ
率	シュツ	ソツ/ソッ	ヒキ	リツ
玉	オウ	ギョク/ギョッ	タマ/ダマ	ダン
王	オウ	オオ	オオキミ	ノウ	ワ
玎	チョウ	テイ	トウ
玐	ハチ	ハツ
玓	チャク	テキ	ヒカ
玕	カン
玖	キ	キュウ	ク/グ	タマ	ヒサ
玗	ウ
玘	キ	タマ
玜	ク	コウ	タマ
玞	フ
玟	バイ	ビン	ブン	マイ	ミン	モン
玠	カイ
玢	タマ	ハン	ヒン	フン	ヘン
玥	ガチ	ゲツ
玦	ケチ	ケツ
玩	ガン	モチアソ	モテアソ
玪	カン	ギン	ケン	ゴン	リン
玫	バイ	マイ	メ
玭	ヒン	ヘン
玲	アキ	アキラ	タマ	リョウ	レ	レイ
玳	タイ	タイマイ
玵	ガン
玷	カ	テン
玹	イシ	ケン
玻	ハ
玼	アザ	サ	サイ	シ	セイ
玽	ク	コウ
玿	ショウ
珀	ハク
珂	カ/ガ
珅	シン
珆	イ	タイ
珈	カ	カミカザリ
珉	ビン	ミン
珊	サン	サンチ	センチ
珋	イシ	リュウ	ル
珌	カザリ	ヒチ	ヒツ	ヘツ	ベチ
珍	ジン	タカラ	チン	メズラ
珎	タカラ	チン	メズラ
珏	カク	コク
珒	シン	タマ
珓	キョウ	コウ
珖	コ	コウ	タマ
珙	キョウ	コウ
珝	ク	タマ
珞	ラク
珠	シュ/ジュ	ス/ズ	タマ	トモ	マ	ミ
珡	キン	コト
珣	シュン	タマ
珥	ジ	ミミダマ
珦	キョウ	ショウ	ドウ
珧	タイラギ	ヨウ
珩	ギョウ	コウ
珪	ケイ	タマ
班	ハン/パン
珮	オビダマ	ハイ
珱	エイ	ヨウ
珴	ガ
珵	ジョウ	チョウ	テイ
珷	ブ	ム
珸	ゴ
珹	ジョウ	セイ	タマ
珺	クン
珻	タマ	バイ	マイ	メ
珽	チョウ	テイ
現	アキラ	アラ	アラワ	ウツ	ウツツ	キラ	ゲン
珿	サク	シュク	スク	ヒト
琀	カン	ゴン	フクミダマ
琁	ケイ	セン
球	キュウ	ク	タマ/ダマ
琄	ギョウ	ケイ	ケン	タマ
琅	ロウ
理	アヤ	オサム	コトワ	コトワリ	サト	サトシ	サトル	タダ	タダシ	トオル	ニ	ノリ	ヒ	マコト	マサ	マサシ	マロ	ミチ	ヨシ	リ
琇	ウ	シュ	シュウ	ユウ
琉	リュウ	ル
琊	ヤ
琑	クサリ	サ	チイサ
琚	キョ	コ
琛	シン	タカラ	チン
琢	アヤ	タカ	タク	ミガ	ミガク
琤	ショウ	ソウ
琥	コ/ゴ
琦	キ	タマ
琨	コン
琩	ショウ	ミミダマ
琪	キ	タマ
琫	フ	ホウ
琬	エン	オン	ワン
琭	コク	タマ	ロク
琮	ス	ソウ
琯	カン	コン
琰	エン
琱	チュウ	チョウ
琲	ツラヌク	ハイ
琳	リン
琴	キン	コト/ゴト
琵	ヒ/ビ
琶	ハ	ベ	ワ
琹	キン	コト
琺	ホウ
琿	コン
瑀	ウ
瑁	バイ	ボウ	マイ	モウ
瑃	チュン
瑄	セン
瑆	ショウ	セイ
瑇	タイ	タイマイ
瑋	イ
瑍	カン
瑑	ウキボリ	テン
瑒	ジョウ	チョウ	トウ
瑕	アラ	カ	キズ	ナンゾ
瑗	エン	オン	カン	ゲン
瑙	ノウ
瑚	コ/ゴ
瑛	アキ	アキラ	エ	エイ	テル	ヨウ
瑜	ユ
瑝	オウ	コウ
瑞	シルシ	スイ/ズイ	ズ	タマ	ミズ	ミズホ	ミツ
瑟	オオゴト	シツ
瑠	リュウ	ル	ルリ
瑢	ユ	ヨウ
瑣	クサリ	サ	チイサ
瑤	タマ	ヨウ
瑦	ウ	オ
瑧	シン	タマ
瑨	シン
瑩	エイ
瑪	バ	メ
瑫	トウ
瑭	タマ	トウ
瑮	ウツク	リチ	リツ
瑯	ロウ
瑰	カイ	タマ	メズラ
瑱	シン	チン	テン	ミミダマ
瑲	ショウ	ソウ
瑳	サ	ミガ
瑶	タマ	ヨウ
瑾	キン
璀	サイ	スイ
璁	ス	ソウ
璃	アキ	リ
璅	サ	ソウ
璆	キュウ	ク	ユ	ユウ
璇	セン
璉	ウツワ	リン	レン
璋	アキラ	ショウ
璏	エ	エイ	エツ	オチ	テイ
璐	ロ
璑	イシ	ブ	ム
璒	イシ	トウ
璘	リン
璙	シロガネ	リョウ
璚	ギョウ	ケイ	ケチ	ケツ
璜	オウ	コウ
璞	アラタマ	ハク
璟	エイ	キョウ	ケイ	ヨウ
璠	タマ	ハン	ボン
璡	シン
璢	リュウ	ル
璣	キ	ケ	タマ
璦	アイ
璧	タマ	ヘキ/ペキ
璨	サン
璩	キョ	ゴ
璪	カザリ	ソウ
璫	トウ	ミミカザリ
璮	タマ	タン
璯	エ	カイ	カザリ	ケ
環	カン	タマ	タマキ/ダマキ	ワ
璱	アザ	シチ	シツ
璲	スイ
璵	ヨ
璹	シュウ	ジュ	タマ	トウ
璻	スイ
璽	ジ
璿	ケ	ケイ	セン
瓈	ライ	リ	レイ
瓉	サン
瓊	ケイ	タマ
瓌	カイ	タマ	メズラ
瓏	ロウ
瓐	ル	ロ
瓓	ラン
瓔	エイ	ヨウ
瓘	カン	タマ
瓚	サン
瓛	カン	ケン	コン
瓜	ウ	ウリ	カ/ガ	ケ
瓞	テツ	デチ
瓟	ハク	ビョウ	ホウ
瓠	カク	コ	ヒサゴ	フクベ
瓢	ヒサゴ	ヒョウ/ビョウ/ピョウ	フクベ
瓣	アラソ	ハナビラ	ヘン/ベン	ワ	ワキマ
瓤	ウリワタ	ショウ	ドウ	ニョウ	ノウ
瓦	カワラ/ガワラ	ガ	グラム
瓧	デカグラム
瓨	カメ	コウ
瓩	キログラム
瓪	ハン	ホン	メガワラ
瓫	アフ	ホトギ	ホン
瓮	オウ	モタイ
瓯	オウ	カメ	ハチ	ホトギ
瓰	デシグラム
瓱	ミリグラム
瓲	トン
瓴	カメ	リイ	リョウ	レイ
瓶	カメ/ガメ	ビン	ヘイ/ベイ/ペイ	ベ	ペ
瓷	カメ	シ
瓸	ヘクトグラム
瓺	カメ	ジョウ	チョウ
瓻	カメ	チ	チャク	テキ
瓼	サラケ
瓿	カメ	フ	ホウ
甃	イシダタミ	シキガワラ	シュウ
甄	ケン	シン	スエ
甅	センチグラム
甆	カメ	シ
甌	オウ	カメ	ハチ	ホトギ
甍	イラカ	ボウ	ミョウ
甎	カワラ	シキガワラ	セン
甑	コシキ	ショウ	ソウ
甒	カメ	ブ	ム
甓	カワラ	ビャク	ヘキ
甕	ウ	オウ	カメ/ガメ	ミカ	モタイ
甖	エイ	オウ	カメ	ホトギ	モタイ	ヨウ
甗	ゲン	コシキ	ゴン
甘	アマ	ウマ	カモ	カン
甚	ジ	ジン	ハナハ
甜	アマ	ウマ	テン	ナ
甞	カツ	ショウ/ジョウ	ナ
生	アサ	イ/イカ	イキ/イギ	イク	イケ	ウ	ウブ	ウマ	ウマイ	ウマレ	エ	オ	オイ	キ	キッ	ギュウ	クルミ	ゴセ	サ	ショウ/ジョウ	スギ	セイ	ソ/ゾ	ソウ	チル	ナ/ナス/ナリ	ナバ	ナマ	ニウ	ニュウ	ハ/バ	フ/ブ	ミ	ム	モウ	ヨイ	リュウ
甠	セイ
甡	シン
産	ウ/ウマ/ウミ	ウブ	サン/ザン	ム	モト
甤	ズイ	ニ
甥	オイ	ショウ	セイ	ソウ	ムコ
甦	コウ	ソ	ヨミガエ
甧	オオ	シン	ソン
用	タカラ	モチ/モチイ	ヨウ
甩	シュツ
甪	ツノ	ロク
甫	スケ	トシ	ナミ	ハジ	ハジメ	フ	ホ/ボ/ポ	ヨシ
甬	ヨウ
甯	デイ	ニュウ	ニョウ	ネイ	ネガ
田	イナカ	オカ	タ/ダ	タン	デ	デン	トウ	ヤ	ンダ
由	ユ	ユイ	ユウ	ユカリ	ヨ/ヨリ	ヨシ
甲	カブト	カン	キ/ギ	キノエ	コウ/ゴウ	マサ	マサル
申	サル	シン/ジン	モウ	モウシ
甶	ヒ	フチ	フツ
男	オ	オトコ	ダン	ナン	ミ	ヲ
甸	カリ	テン/デン
甹	セワ	ビョウ	ヘイ
町	チョウ	マチ
画	エ	エガ	カイ	カギ	カク/カッ	ガ	ハカ	ハカリゴト
甼	チョウ	マチ
甽	キョウ	ケイ	ケン	ミゾ
甾	カメ	シ
甿	ボウ	ミョウ	モウ
畀	アタエルモノ	ヒ
畃	イイツ	シュン
畄	ト	トド	リュウ	ル	ルウブル
畆	ウネ	セ	ホ	ボウ	ム	モ
畇	イン	キン	シュン	タガヤ
畈	ハン	ホン
畉	タガヤ	フ
畊	キョウ	コウ	タガ
畋	カリ	テン/デン
界	カイ/ガイ	サカイ
畍	カイ	サカイ
畎	キョウ	ケン	テイ	ミゾ
畏	イ	オソ/オソレ	カシコ	カシコマ
畐	ヒキ	ヒョク	フク
畑	カマ	ハタ/バタ/パタ	ハタケ/バタケ	ママ
畒	ウネ	セ	ホ	ボウ	ム	モ
畔	アゼ	クロ/グロ	ハン	ホトリ
畗	トウ	フク	ミ
留	ト/トマ/ド	トド	トマ/ドマ	トメ/ドメ	リュウ	ル	ルウブル
畚	フゴ	ホン	モッコ
畛	アゼ	シン
畜	チク
畝	ウネ	セ/ゼ	ホ/ポ	ボウ	ム	モ
畞	ウネ	セ	ホ	ボウ	ム	モ
畟	シキ	ショク	ソク
畠	ハタ/バタ	ハタケ/バタケ	ハナ
畡	カイ	ハテ
畢	アミ	オワ	コトゴトク	ヒツ/ヒッ
畤	シ/ジ
略	オカ	オサ	ハカ	ハカリゴト	ハブ	ホボ	リャク/リャッ
畦	アゼ	ウネ	ケイ
畧	オカ	オサ	ハカ	ハカリゴト	ハブ	ホボ	リャク
畩	ケサ
番	ツガ	ツガイ	ハ/バ	バン	マ
畫	エ	エガ	カイ	カギ	カク	ガ	ハカ	ハカリゴト
畭	シャ	ハリ	ヨ
畯	シュン
異	アヤ	イ	ケ	コト
畱	ト	トド	リュウ	ル	ルウブル
畳	カサ	ジョウ	タタ/ダタ	タタミ/ダタミ	タトウ	チョウ
畴	ウネ	タグイ	チュウ	ヒト
當	ア	ト	トウ/ドウ	マサ
畷	セイ	テイ	テツ/テッ	ナワテ
畸	キ
畹	エン
畺	キョウ	コウ	サカイ
畻	アゼ	クロ	ショウ	ツツ
畼	ジョウ	チョウ	ナガ	ニワ	ノ
畽	ソロワナイ	タン	ツ	トウ	トン
畾	スイ	トリデ	ライ	ルイ
畿	キ	ミヤコ
疁	キク	コク	ヤキバタ	リュ	リュウ	ル
疂	カサ	ジョウ	タタ	タタミ	チョウ
疅	キョウ	コウ	サカイ
疆	キョウ	サカイ
疇	ウネ	タグイ	チュウ	ヒト
疉	カサ	ジョウ	タタ	タタミ	チョウ
疊	カサ	ジョウ	タタ	タタミ	チョウ
疋	アシ	ショ	ソ	ヒキ/ビキ/ピキ	ヒツ
疎	ウト	オロ	オロソ	ショ	ソ	マバ
疏	アラ	ウト	ショ	ソ	トオ	マバ	マバラ
疐	シ	タイ	チ	ツマズ	テイ
疑	ウタ/ウタグ	ウタガ	ギ
疒	シツ	ジョウ	ソウ	ダク	ニャク	ヤ	ヤマイダレ
疓	キュウ	ザイ	ダイ	ナイ	ネ	ホッス	ヤ	ヤマイ
疔	チョウ	テイ
疕	デキモノ	ヒ
疙	オロ	キ	ギツ	ケ	ゴチ
疚	キュウ	ヤ	ヤマ
疜	カ	ゲ	ハラクダシ
疝	サン	セン
疢	チン
疣	イボ	ユ	ユウ
疤	ハ	ヘ	ヤマイ
疥	カイ	ハタケ
疫	エキ	ヤク
疱	ホウ/ボウ	モガサ
疲	ツカ/ヅカ	ヒ
疳	カン
疴	ア	ヤマイ
疵	キズ	シ
疸	タン/ダン
疹	シン	チン	ハシカ
疺	ヘン	ホウ	ヤセ
疼	イタ	ウズ	トウ
疽	カサ	ショ	ソ
疾	シツ/シッ	ト	ハヤ	ヤマ
疿	アセモ	ヒ
痀	ウ	ク	セムシ
痁	オコリ	セン	テン
痂	カ	カサ	カサブタ	ケ
痃	ケン/ゲン
痄	サ	ジャ
病	ビョウ	ヘイ/ペイ	ヤ/ヤミ	ヤマイ
痆	カユ	キズ	キズイタミ	ジツ	ダツ	ナチ	ニチ
症	ショウ
痊	セン
痌	イタ	ズ	トウ
痍	イ	キズ
痎	オコリ	カイ
痏	イ	ウ	ウチキズ	ユウ
痒	カサ	カユ/ガユ	ヨウ
痔	シモガサ	ジ	ヂ
痕	アト	コン
痗	カイ	バイ	マイ	ヤ
痘	トウ
痙	ケイ	ツ	ヒキツ
痛	イタ	ツウ
痜	カサ	トク
痞	ツカエ	ヒ
痟	ショウ	ヅツウ
痠	イタ	サン
痡	フ	ホ	ヤ
痢	リ
痣	アザ	シ	ホクロ
痤	エノゴ	サ	ハレモノ
痧	コレラ	サ
痩	コ	シュ	シュウ	ソウ	チュウ	ヤ/ヤセ
痬	ウツ	エキ	オロ	シャク	セキ	ヤク
痮	チョウ	ハ	フク
痯	カン	ヤ
痰	タン
痱	ハイ	ヒ
痲	シビ	バ	マ
痳	リン
痴	オロカ	シ	チ
痹	シビ	ヒ
痺	シビ	ヒ
痼	コ	シコリ
痾	ア	ヤマイ
痿	イ	ナ
瘀	オ	ヤマイ	ヨ
瘁	スイ	ツカ
瘂	ア	オシ
瘃	シモヤ	ショク	ソク	チョク	トク
瘄	シャク	ヤマイ
瘇	ショウ	ジュ	ハ
瘈	クル	ケイ	セイ
瘉	イ	イヤ	ユ
瘊	イボ	グ	コウ
瘋	フウ
瘌	キズ	ライ	ラチ	ラツ
瘍	カサ	ヨウ
瘏	ズ	ト	ヤ
瘒	オロ	ゴン
瘓	タン	ヤ
瘕	カ	ケ	ヤマイ
瘖	イン	オシ	オン
瘙	カサ	ソウ
瘛	セイ	セチ	セツ	ヒキツ
瘜	ショク	ソク
瘝	カン	ケン	ヤ
瘞	ウズ	エイ
瘟	エヤミ	オン
瘠	ジャク	セキ	ヤ	ヤセ
瘡	カサ	クサ	ショウ	ソウ
瘢	キズ	ハン
瘣	カイ	ヤ	ライ
瘤	コブ	リュウ	ル
瘥	イ	サ	サイ	シャ
瘦	シュウ	ソウ	チュ	チュウ	ヤセ
瘧	オコリ	ガク	ギャク
瘩	トウ	ハレモノ
瘭	ハレモノ	ヒョウ
瘰	ラ	ライ	ルイ
瘲	シュ	ショウ	ヒキツ
瘳	イ	チュ	チュウ	リョウ
瘴	ショウ
瘵	サイ	セイ	ヤ
瘸	カ	クウ
瘹	クル	チョウ
瘺	カサ	セムシ	デキモノ	ル	ロウ
瘻	カサ	セムシ	デキモノ	ル	ロウ
瘼	バク	マク	ヤ
癀	オウ	コウ
癁	フク	ヤ
療	リョウ
癃	ツカ	リュ	リュウ
癄	ショウ	ソウ	ヤセ	ヤツ
癅	コブ	リュウ	ル
癆	ロウ
癇	カン	ヒキツケ
癈	ハイ
癉	タ	タン	ヤス
癊	イン	オン
癋	カク
癌	ガン
癒	イ	イヤ	ユ
癕	ハレモノ	ヨウ
癖	クセ/グセ	ヘキ/ペキ
癘	エヤミ	ライ	レイ
癙	ショ
癜	テン/デン	ナマズ
癟	トベナイ	ハツ	ヘツ	ベチ
癡	オロカ	シ	チ
癢	カユ	ヨウ
癤	カサ	セチ	セツ
癥	シコリ	チョウ
癧	レキ
癨	カク
癩	カッタイ	ライ
癪	シャク
癬	セン/ゼン	タムシ
癭	エイ	コブ	ヨウ
癮	イン	オン	ハレモノ
癯	ク	ヤセ
癰	ハレモノ	ヨウ
癱	シビ	タン
癲	テン
癴	ヤ	ヤセ	レン
癶	ハツ	ハツガシラ
癸	キ	ミズノト
発	アバ	オコ	タ	ツカ	ハツ/ハッ/パツ	ハナ	バ	ホツ/ホッ/ボツ	ワ
登	ア	ショウ	タカ	チョウ	ト/ド	トウ/ドウ	ノボ/ノボル	ノボシ	ノボリ	ノリ
發	アバ	オコ	タ	ツカ	ハツ	ハナ	バ	ホツ
白	アキ	カ	シラ/ジラ	シロ/ジロ	チロ	ハク/ハッ/バク/パク	ビャク/ビャッ
百	オ	ド	ドウ	ナリ	ヒャク/ヒャッ/ビャク/ピャク	ヒュク	モ	モモ	モンド	ユ
皀	キュウ	キョウ	コウ	ヒョク
皁	シモベ	ソウ
皃	カタチ	カタドル	バク	ボウ
的	イクハ	イクワ	テキ	マト	ユクハ
皅	ハ	ヘ
皆	カイ/ガイ	ミ	ミナ	ミンナ	ムナ
皇	オウ	オウジ	オオ	コウ	スメラギ	ミ
皈	オク	カエ	キ	トツ
皋	コウ	サツキ
皌	バツ	マチ
皍	スナワ	ソク	ツ
皎	アキラ	キョウ	キヨ	コウ	シロ
皐	コウ	サツキ	タカシ
皓	アキ	アキラ	コウ	シロ	テル	ヒカ	ヒロ	ヒロシ
皕	ヒ	ヒキ	ヒョク
皖	カン
皙	シャク	シロ	セキ
皚	カイ/ガイ	ギ	ゲ	サム	シロ
皛	アラワ	キョウ	テイ	ハク
皜	コウ
皝	オウ	コウ
皟	キヨ	サク	ヤセ
皠	サイ	シロ	セ
皢	アキ	キョウ	シロ
皣	ヨウ
皤	ハ	ハン
皥	アキ	コウ
皦	キョウ	シロ
皧	アイ	キヨ
皨	ショウ	セイ	ホシ
皪	シロ	ハク	ラク	リャク	レキ
皭	ザク	シャク	ショウ	シロ
皮	カワ/ガワ	ケガワ	ヒ/ビ/ピ
皰	ニキビ	ビョウ	ホウ
皴	シュン	シワ	ヒビ
皷	コ	ツヅミ
皸	アカギレ	キン	クン	ヒビ
皹	アカギレ	キン	クン	ヒビ
皺	シボ	シュウ	シワ/ジワ	スウ
皽	カワ	シュウ	セン	タン	テン
皿	サラ/ザラ	ベイ
盁	エイ	ミ
盂	ウ	ハチ
盃	サカズキ	ハイ/パイ
盅	ジュ	チュウ	ムナ
盆	ボン
盈	エイ	ミ	ミツ	ミツル
盉	カ	クウ	トトノ	ワ
益	エキ	マ	マシ	マス	ヤク
盋	ハチ	ハツ	ワン
盌	ワン
盍	オオ	コウ	ナンゾ
盎	オウ	ハチ
盒	コウ/ゴウ	サラ	フタモノ
盔	カイ	ハチ
盖	オオ	カイ/ガイ	カコウ	カサ	ケダ	コウ	フタ
盗	ト	トウ	ヌス
盙	フ
盛	サカ/サカリ/サカン/ザカ	サカリ/ザカリ	ジョウ	セイ/ゼイ	モ/モリア	モリ
盜	トウ	ヌス
盞	サカズキ	サン	セン
盟	メイ
盠	ヒサゴ	ライ	リ	レイ	ワリゴ
盡	コトゴト	サカヅキ	サン	ジン	ツ	ママ
監	カン	ケン/ゲン
盤	チ	バン	ワ
盥	カン	ソソ	タライ/ダライ
盦	アン	オウ	オン	フタ
盧	ノ	ロ
盨	ウツワ	シュ	ショ	ス	ソ
盪	アラ	ウゴ	トウ	トロ
盬	アラシオ	ク	コ
目	サカン	サガン	サッカ	サツカ	ノメ	ボク	マ	メ/メガ/メザ/メダ/メッ	モク/モッ
盰	カン	シロメ
盱	ウ	ク	コ
盲	メクラ	メシ/メシイ	モウ
直	ジカ	ジキ	ス	スグ	スナオ	タダ	タダシ	チョク/チョッ	ナオ/ナオシ/ナオリ	ノウ	ノオ	ヒタ
盶	オト	ガン	ギン	ゲン	モト
相	ア	アイ/アイワ	イ	オウ	サ	サガ	ショウ	スケ	ソウ/ゾウ
盹	シュン
盻	ケイ	ニラ
盼	ハン	フン	ヘン
盾	ジュン	タテ/ダテ
眀	ベイ	ミョウ	ミル
省	カエリ	サトシ	ショウ	セイ	ハブ	ミ
眄	カエリ	ベン	メン
眆	ナラ	ホウ	ホノ
眇	スガ	スガメ	ビョウ	ミョウ
眈	タン	ニラ
眉	ビ	マユ	ミ
眊	クラ	バク	ボウ	マク	モウ
看	カン	ミ
県	アガタ	カ	ガタ	ケン
眎	シ	ミ
眒	オドロ	シン	ハヤ	ミハ
眔	トウ
眕	シン	チン
眗	ク	コウ
眙	イ	チ	チョウ	ミ
眚	ショウ	セイ
眛	クラ	バイ	マイ
眜	クラ	バツ	ベツ	マチ	メチ
眞	サナ	シン	チ	マ	マコ	マコト	マサ	マツ
真	サナ	サネ/ザネ	シン/ジン	タダ	タダシ	ナオ	ノリ	マ	マア	マコ/マゴ	マコト	マサ/マザ	マッ	マド	マナ	マユ	ミチ	モ
眠	ネ	ネム	ネムリ	ミン
眢	エン	オン	ワン
眤	イ	ケイ	ダイ	テイ
眥	イシ	サイ	シ	セ	セイ	マナジリ	メジリ
眦	イシ	サイ	シ	セ	セイ	マナジリ	メジリ
眨	ショウ	ソウ	マタタ
眩	カン	クラ	クルメ	クレ	ゲン	マ/マイ	マド	マバユ	マブ	メマ
眭	エ	キ	ケイ	スイ
眮	ズ	トウ	マブチ	ミマワ
眯	クル	ビ	ベイ	マイ	ミ
眴	ケン	シュン	マタタ	メクワ
眵	シ	マナジリヲイタ
眶	キョウ	コウ	マブタ
眷	カエリ	ケン
眸	ヒトミ	ボウ	ム
眹	ショウ	ジン	チン	ヒトミ
眺	チョウ	ナガ/ナガメ
眼	ガン	ゲン	マナコ	メ
眽	バク	ベキ	ミャク
眾	オオ	シュ	シュウ
着	キ/キセ/ギ	ジャク	チャク/チャッ	ツ	トン
睂	ビ	マユ	ミ
睅	カン	ゲン
睆	カン	ゲン	ワン
睇	ダイ	テイ
睊	エン	ダン	ヌスミ
睍	ケン
睎	キ	ケ
睏	コン	ネム
睒	セン	ダン	ヌスミ
睖	チョウ	ミル	リョウ
睗	イナビカリ	シャク	セキ
睚	ガイ	マナジリ
睛	ショウ	セイ	ヒトミ
睜	ジョウ	セイ	メッキ
睞	ミル	ライ
睟	アキ	サイ	スイ
睠	カエリ	ケン
睡	スイ	ネム
睢	キ	ケ	ケイ	スイ	ミア
督	タダ	タダシ	トク
睤	ナガシメ	ヘイ	ミ
睥	ナガシメ	ヘイ	ミ
睦	アツ	アツシ	チカ	ボク	ム	ムツ	ムツミ	ムネ	モク	ヨシ
睧	クラ	コン
睨	ゲイ	ニラ	ニラミ	ニラメ	ネ
睪	ウカガイ	エキ	ジョウ	ニョウ	ヤク
睫	ショウ	マツゲ
睬	サイ
睰	バツ	マチ	ミル
睲	ショウ	セイ	ヒトミガカガヤ	ミル
睳	カス	ケ	ケイ
睴	コン	ミル
睹	ト	ミ
睺	カタ	グ	コウ
睽	キ	ケ	ケイ
睾	コウ
睿	アキ	エイ
瞀	バク	ボウ	ボツ	マク	ム	モ
瞄	ビョウ	ミ
瞋	イ	イカ	シン
瞌	コウ
瞍	ショウ	ス	ソウ	メクラ
瞎	カタメ	カツ	メクラ
瞑	クラ	ツブ	ツム	ベン	ミョウ	ミン	メイ	メン
瞔	サク	シャク
瞕	カス	ショウ
瞖	エイ
瞚	シュン	マタタ
瞞	ダマ	バン	ボン	マン	モン
瞟	ヒョウ	ミ
瞠	トウ/ドウ	ミハ
瞢	クラ	ボウ	ム	モウ
瞥	ヘツ/ベツ	ベツ/ベッ
瞧	ショウ	ヌスミ
瞪	トウ	ミハ
瞬	シバタ	シバタタ	シュン	マジロ	マタタ	マドカ	マバタ
瞭	アキラ	アキラカ	リョウ
瞮	アキ	テチ	テツ
瞯	ウワメヅカイ	カン	ケン	ナガシメ
瞰	カン	ミ
瞱	ヨウ
瞳	アキラ	トウ/ドウ	ヒトミ
瞵	ヒトミ	リン	レン
瞶	キ
瞹	アイ
瞻	セン	ミ
瞼	ケン	マブタ
瞽	コ	メシ
瞾	ショウ	テ
瞿	オソ	ク	ミ
矃	ゲイ	デイ	ニョウ	ネイ
矇	クラ	ボウ	メシ	モウ
矉	ニラ	ヒン
矍	カク
矑	ミル	ル	ロ
矒	クラ	ボウ	ム	モウ
矕	バン	マン	ミ	ミソナ	ラン
矗	シュク	チク	チョク	ナオ	ノブ
矙	カン	ミ
矚	ショク	ソク	ミ
矛	ホコ	ボウ	ム
矜	アワ	キョウ	キン	ケイ	ツツシ	ホコ
矞	アナヲア	イチ	イツ	シュツ	ジュチ
矟	サク	ホコ
矠	サク	シャク	ホコ
矢	シ	ヤ
矣	イ
矤	イワ	シン	ハ	ハギ
知	サト	サトル	シ/シラ/シル/ジ	シリ/ジリ	シレ	チ/ヂ	トモ	ノリ
矦	コウ
矧	イワ	シン	ハ	ハギ	ハグキ
矩	カネ/ガネ	カネザシ	ク	サシガネ	タダシ	ツネ	ノリ
矪	クルリヤ	チュ	チュウ
矬	サ
短	タン	ミジカ
矮	アイ	ヒク	ワイ
矯	キョウ	タ
矰	ソウ
矱	モノサシ	ワク
石	イサ	イシ/イジ	イス	イワ	コク/ゴク	シ/ジ	シャク/ジャク	セキ/ゼキ	セッ	セック	ト
矴	イカリ	テイ
矸	カン	キヌタ
矻	イシ	カチ	カツ	クチ	コツ
矼	コウ	バシ
砂	イサ	イサゴ	ゴ	サ/ザ	シャ/ジャ	スナ/ズナ
砅	ヒョウ	リ	レイ	ワタ
砆	イシ	フ
砉	カク	キャク	ケキ	ワク
砌	サイ	セイ/ゼイ	ミギリ
砍	カン	キ	キン	コン
砎	カイ	カタ	カツ	ケチ
砑	ガ	ゲ	スル
砒	ヒ	ヘイ
研	ケン	ト/トギ	ノリ	ミガ
砕	クダ	サイ
砝	カタ	キョウ	コウ	ホウ
砠	ショ	ソ
砡	ギク	ギョク	ゴク	ソロ
砢	イシヅミ	カ	ラ
砣	イシ	タ
砥	キイ	シ	チ	テイ	ト/トギ/ド	トイシ	ミガ
砦	サイ	トリデ
砧	キヌタ/ギヌタ	チン
砭	イシバリ	ヘン
砮	ド	ヌ	ヤジリ
砰	ヒョウ	ホウ
砲	ヅツ	ホウ/ポウ
破	ハ/バ/パ	ヤ	ヤブ	ヤブリ	ワ/ワレ
砵	オウ	ハツ
砷	シン
砺	アラト	ト	ミガ	レイ
砿	アラガネ	コウ
硃	シュ
硄	コウ
硅	カク	キャク	ケイ	ヤブ
硇	ドウ	ニョウ
硈	カタ	カツ	ケチ
硌	ラク	リャク	レキ
硎	ケイ	トイシ
硒	セイ
硜	キョウ	ケイ	コウ
硝	ショウ
硞	カク	キャク	コク
硠	ロウ
硡	コウ
硣	キョウ	コウ
硤	ギョウ	コウ
硨	シャ
硪	イソ	イワオ	ガ	ギ
硫	リュウ
硬	カタ	コウ
确	カク
硯	ケン/ゲン	スズリ
硲	サコ	ハザ	ハザマ
硴	カキ
硺	ウ	タク	チョク
硼	ホウ
硾	ズイ	ダ	ツ	ツイ
碁	ゴ
碆	ハ/バ	ハエ	ハヤ	バエ	バヤ
碇	イカリ	テイ
碊	ウツ	オク	サカ	サン	セン	ソソ	ノ
碌	ロク
碍	ガイ	ゲ	サマタ
碎	クダ	サイ
碏	サク	シャク	セキ	ツツシ
碑	イシブミ	ヒ/ビ/ピ
碓	ウ	ウス	カク	タイ	タシ
碔	ブ	ム
碕	キ	サイ	サキ	ミサキ
碗	コバチ	ワン
碘	テン
碚	ハイ
碝	ゼン	ネン
碞	イワ	ガン	ケワ
碟	カツ	カワグツ	ガチ	セツ	ゼチ
碡	ジク	チク	トク
碣	イシブミ	ケツ
碤	イシ	エイ	ヨウ
碧	アオ	アオイ	タマ	ヒャク	ヘキ/ペキ	ミドリ
碨	イ	エ	ワイ
碩	オオ	セキ
碪	キヌタ	チン
碬	カ	ケ/ゲ	トイシ
碭	イシ	トウ
碯	ノウ
碰	ブツカ	ホウ
碱	ア	カン	ケン	セン
碲	テイ
碳	タン
碵	イシズエ	セキ	ヒロ	ミチ	ミツル
確	カク/カッ	コウ	シッカ	タシ
碻	カク	コウ	タシ
碼	バ	メ	ヤアド	ヤアル
碽	ク	コウ
碾	ウ	テン	ヒ/ヒキ
碿	ソチ	ソツ	ミガ
磁	ジ
磅	ホウ/ボウ	ポンド
磆	カツ
磇	ヒ	ヘイ
磈	イ	カイ	キ	ケワ
磉	イシズエ	ソウ
磊	ライ
磋	サ	ミガ
磌	シン	テン
磎	ケイ	タニ	タニガワ
磐	イワ	イワオ	ハン/バン	ワ
磑	ウ	ガイ
磒	イン	ウン	エン	オチ
磓	ウ	オ	ズイ	タイ	ツイ	テ
磔	サ	タク/タッ	チャク	ハリツケ	ヒラク
磕	カイ	カチ	カツ	コウ
磖	ロウ
磚	カワラ	セン
磛	ケワ	サン	セン
磟	リク	ロク
磠	スナ	ロ
磡	カン	コン
磤	イン	オン
磦	ヒョウ	ミネ
磧	カワラ/ガワラ	セキ
磨	オサム	ス/スリ	ト/トギ	マ	ミガ/ミガキ/ミガク
磪	ケワ	サイ	スイ
磬	カオル	ケイ
磯	イソ	キ	シ	ソ/ゾ
磲	キョ	ゴ
磳	イシ	ジョウ	ソウ
磴	トウ
磶	イシズエ	シャク	セキ
磷	ウス	ウスイ	キララ	ナガ	リョウ	リン	ロウ
磺	アラガネ	コウ
磻	イシ	ハ	ハン
磽	キョウ	コウ
磿	リャク	レキ
礀	カン	ケン	タニ
礁	ショウ	バエ
礆	ケワ	ケン
礇	イク
礌	オ	ライ
礎	イシズエ	ソ	モト
礐	カク	コク
礑	トウ	ハタ	ハタト
礒	イソ	イワオ	ガ	ギ
礙	ガイ	ゲ	サマタ
礚	カイ
礜	ヨ
礞	イシ	ボウ	ム
礟	イシハジキ	ホ	ホウ
礠	ジ
礥	キン	ケン	ムツカ
礦	アラガネ	コウ
礧	ライ	ルイ
礩	イシズエ	シチ	シツ
礪	アラト	ト	ミガ	レイ
礫	コイシ	ツブテ	レキ
礬	ハン/バン
礭	カク	ムチ
礱	ト	ル	ロウ
礴	ハク	マ
礵	ソウ	ヒソ
示	シ/ジ	シメ
礻	シ	シメスヘン	ネヘン
礼	アヤ	ナリ	ノリ	ヒロシ	フダ	ライ	レ	レイ
礽	サイワ	ジョウ	ニョウ
社	コソ/ゴソ	シャ/ジャ	ヤシロ	ンシャ
礿	マツリ	ヤク	ヨウ
祀	シ	マツ	マツリ
祁	キ	ケ/ゲ
祄	カイ	タス
祅	ヨウ	ワザワ
祆	ケン	テン
祇	カミ	キ/ギ	クニツカミ	シ	タダ	マサニ
祈	イノ	キ	ネ	ノリ	レイ
祉	シ
祊	ヒョウ	ホウ	マツリ
祋	タイ	タチ	タツ	ホコ
祏	イハイ	ジャク	セキ
祐	ウ	サチ	スケ	タス	タスク	ヒロ	ヒロシ	マサ	ユウ	ヨシ
祑	ジチ	チツ
祓	ハイ	ハラ/バラ	ハライ	フツ
祔	アワセマツ	フ
祕	カク	ヒ
祖	イ	ソ/ゾ
祗	シ	ツツシ	マサニ
祘	カゾ	サン
祚	クラ	サイワ	ソ
祛	キョ	コ	ハラ
祜	コ	サイワ
祝	イワ/イワイ	シュウ	シュク	ノリ	ハジメ	ホウリ	ホギ	ユワイ
神	カ/ガ	カグ	カナ/ガナ	カミ	カモ	カン/ガン	ガミ	クマ	コ	コウ/ゴウ	コハ	シン/ジン	ダマ	ミ
祟	スイ	タタ	タタリ
祠	シ	ホコラ	マツル
祢	デイ	ナイ	ネ
祥	アキ	アキラ	キザ	サイワ	サカ	サキ	サチ	サム	ショウ/ジョウ	タダ	ツマビ	ナカ	ナガ	ヒロ	マサ	ヤス	ユキ	ヨ	ヨシ
祧	チョウ
票	ヒョウ/ピョウ
祩	シュ	チュ	ノロ
祫	ギョウ	コウ	マツ
祭	サイ/ザイ	マツ	マツリ
祲	シン
祷	イノ	トウ	マツ
祹	サイワ	トウ
祺	キ	サイワ	ヤス
祻	ク	コ	マツリ
祼	カン	マツリ
祾	イツク	リョウ	ロウ
祿	サイワ	フチ	ロク
禀	コメグラ	ヒン	リン
禁	キン
禄	サイワ	トシ	フチ	ヨシ	ロク/ロッ
禅	シズカ	セン/ゼン	ユズ
禊	カツ	ケイ	ハラ	ミソ	ミソギ
禋	イン	エン	マツ
禌	イコ	シ
禍	カ	マガ	ワザワイ
禎	サイワ	サダ	サチ	タダシ	テイ	トモ	ノリ	ヨシ
福	トシ	トミ	フ/ブ	フキ/ブキ	フク/フグ/フッ/ブク/プク	ボク	ヨシ
禑	グ	ゴ	サイワ
禓	ショウ	マツリ	ヨウ
禔	サイワ	シ	ダイ	テイ
禕	イ	ヨイ
禖	バイ	マイ
禘	ダイ	テイ	マツリ
禛	ウ	シン
禜	エイ	ヨウ
禝	キビ	ショク
禡	バ	マツリ	メ
禦	ギョ	ゴ	フセ
禧	キ	サイワ
禨	キ	キザシ	ケ
禩	シ
禪	シズカ	セン/ゼン	ユズ
禫	タン	ドン	マツリ
禮	ヒロ	ライ	レ	レイ
禯	ジョウ	チョウ	ニュ	マツリ
禰	デイ	ナイ	ネ
禱	イノ	トウ	マツ
禳	ジョウ	ハラ
禴	マツリ	ヤク	ヨウ
禸	アシアト	グウノアシ	ジュウ	ニュ
禹	ウ
禺	オナガザル	グ	グウ
离	チ	リ
禽	キン	トリ/ドリ	トリコ
禾	イネ	カ	ノギ	ノギヘン
禿	カブロ	カムロ	チ	チビ	トク	ハ	ハゲ
秀	シゲル	シュ	シュウ	ショウ	ヒイ	ヒデ	ヒデシ	ホ
私	シ	ワタ	ワタクシ	ワタシ
秂	ジン	ニン
秄	シ	ツチカ
秇	ウ	ウン	ゲイ	ノリ	ワザ
秈	ウルチ	セン
秉	ト	ヘイ
秊	トシ	ネン
秋	アイ	アキ	シュウ/ジュウ	トキ
秏	カイ	コウ	ボウ	モウ
科	カ	シナ/ジナ	トガ
秒	ビョウ
秔	ウルチ	コウ	ヌカ
秕	シイナ	ヒ
秖	シ	ミノ
秘	カク	ヒ/ヒメ/ピ	ヒソ
秚	ハン	ヤワ
秝	ナラ	リャク	レキ
秞	シゲ	ユ	ユウ
租	ソ
秠	クロキビ	ヒ	ヒュ	ヒュウ	フ	フウ
秡	ハツ	ハライ	バチ
秢	ヨワイ	リョウ	レイ
秣	バツ	マグサ	マグサカウ	マツ
秤	ショウ	ハカリ/バカリ	ヒン/ビン
秥	イネ	デン	ネン
秦	シン/ジン	タイ	ハタ	ハダ	ヤス
秧	オウ	ナエ
秩	チチ	チツ/チッ
秪	チ	ミノ
秫	オケラ	シュツ	ジョツ	チュツ	モチアワ
秬	キョ	クロキビ
秭	シ
称	ア	カナ	ショウ	ソヤ	タタ	トナ	ネ	ハカ	ホメ
秱	ズ	トウ
秸	カイ	カツ	ケチ	ワラ
移	イ	ウツ/ウツシ	ウツリ
秼	シュ	ノロ
稀	キ	ケ	マバラ	マレ
稂	イヌアワ	リョウ	ロウ
稃	フ	フウ	モミガラ
稇	ウ	クク	コン
稈	カン	ワラ
稉	ウルチ	コウ	ヌカ
稊	イヌビエ	ダイ	テイ
程	テイ	ホト	ホド
稌	イネ	ショ	ズ	ト
稍	ショウ	ソウ	ヤヤ	ヨウヤク
税	サイ	ゼイ	ミツグ
稑	リク	ロク	ワセ
稔	ジン	トシ	ナリ	ナル	ニン	ネ	ネン	ミ	ミノ	ミノリ	ミノル
稕	シュン	ワラタバ
稗	ハイ	ヒ	ヒエ/ビエ
稘	キ
稙	ショク	タネ	チョク
稚	イトケナ	イトケナイ	オクテ	オサナイ	オデル	ジ	チ	マサ	ワカ	ワク	ワッカ
稛	キン	クク	クン	コン
稜	イツ	カド	ソバ	リョウ	ロウ
稞	カ	ゲ	ムギ	ラ
稟	コメグラ	ヒン/ピン	リン
稠	オオ	シ	チュウ	チョウ
稡	アツ	サイ	セ	ソチ	ソツ
稧	ケイ	ケチ	ケツ	ミソギ	ワラ
稫	シゲ	ヒキ	ヒョク
稭	カイ	カツ	ケチ	ワラ
種	オイ	クサ/グサ	シュ/ジュ	タ	タネ/ダネ	ホ
稯	ス	ソウ	タバ
稰	ショ
稱	ア	カナ	ショウ	タタ	トナ	ハカ	ホメ
稲	イチ	イナ	イネ	イノ	シネ	セ	テ	トウ	ナ
稴	ウルチ	カン	ケン	レン
稵	ウ	シ	シュウ	マ	マス
稷	キビ	ショク
稸	キク	コク	タクワエ	チク	ツ	トク
稹	シゲ	シン	テン	ヘン
稺	イト	オクテ	オゴ	オサナ	ジ	チ
稻	イナ	イネ	テ	トウ
稼	カ	カセ
稽	カンガ	ケイ/ゲイ	トド
稾	コウ	シタガキ	ワラ
稿	コウ	シタガキ	ワラ
穀	コク/ゴク	タケ
穂	オ	コウ	スイ	ノリ	ホ/ボ/ポ	ホイ	ミノル
穃	ヨウ
穄	クロキビ	サイ	セイ
穅	コウ	ヌカ	ムナ
穆	アツシ	キヨシ	ボク	モク	ヤワ
穇	サン	シン	ヒエ
穈	ビ	ボン	ミ	モン
穉	イト	オク	オゴ	オサ	ジ	チ
穌	カキアツ	ソ
積	カ	サカ	シャコ	ズミ	セキ/セギ	セッ	ツ/ツム/ツモ/ヅ	ツミ/ヅミ	ツモ/ツモリ/ツモル	ツモリ/ヅモリ	ヅモ
穎	エイ	ノギ	ホサキ
穏	オダ	オン
穐	アキ	シュウ	トキ
穕	ショウ
穖	キ	ケ
穗	オ	スイ	ホ	ミノル
穙	シゲ	ホク
穜	オクテ	シュ	ショウ	ズ	トウ
穝	サイ
穟	スイ	ホ
穠	シゲ	ジョウ	ニュ
穡	ショク
穢	アイ	エ	キタナ/ギタナ	ケガ	ケガレ	ワイ
穣	シゲ	ジョウ	ミノル	ユズル	ユタカ	ワラ
穥	ウ	ヨ
穧	カリイネ	ザイ	シ	セイ
穩	オダ	オン
穪	ア	カナ	ショウ	タタ	トナ	ハカ	ホメ
穫	カ	カク
穭	リョ	ロ
穰	ジョウ	ミノル	ユタカ	ワラ
穴	アナ	ケツ/ケッ	ケナ	シシ	ナ
穵	アツ	アナ	エチ
究	キュ	キュウ	キワ/ギワ	キワム	ク
穸	キュウ	ジョク	セキ	ヨ
穹	アメ	キュウ	キョウ	ソラ
空	ア	アキ	ウツ	カラ	キ	ク	クウ	ス	ソラ/ゾラ	ムナ
穽	オトシアナ	セイ/ゼイ
穾	フカ	ヨウ
穿	ウガ	セン	ハ/バ
窀	アツ	タン	チュン	トン
突	カ	ツ/ツキ/ツク/ツッ/ヅ	ツキ/ヅキ	ツク/ヅク	ツツ	トツ/トッ
窂	オリ	ミ	ロウ
窃	セツ/セッ	ヌス	ヒソ
窄	サク	スボ	スボマ	スボミ	セマ	ツボ
窅	オウ	ベン	メン	ヨウ
窆	ビン	ヘン	ホウ	ホウム
窈	ヨウ
窊	エ	クボ	ユ	ワ
窋	タチ	タツ	チュツ
窐	ウツロ	エ	ケ	ケイ	コウ	ワ
窑	カマ	ヨウ
窒	チツ/チッ
窓	ケムダシ	ス	ソウ	テンマド	マド
窔	フカ	ヨウ
窕	ウツク	ウツロ	チョウ	ヨウ
窖	アナグラ	キョウ	コウ
窗	ケムダシ	ス	ソウ	テンマド	マド
窘	キン	クルシ	タシナ
窞	アナ	タン	ドン	ラン
窟	アナ	イハヤ	イワヤ	クツ	コツ
窠	カ	ス
窣	ソチ	ソツ
窩	カ	ムロ	ワ
窪	ア	クボ	ワ
窬	クグリド	ズ	トウ	ユ
窮	キュウ	キョウ	キワ
窯	カマ/ガマ	ヨウ
窰	カマ	ヨウ
窳	エ	クボ	ユ	ワ
窵	オクフカ	チョウ	トウ
窶	ク	ヤ	ヤツ	ル	ロウ
窹	カマド	ゴ
窺	ウカガ	キ	ノゾク
窻	ケムダシ	ス	ソウ	テンマド	マド
窼	ショウ	ソウ	ネグラ
窿	リュウ
竃	カマ/ガマ	カマド	ソウ	ヘッツイ
竄	カク	サン/ザン	ノガ
竅	アナ	キョウ
竆	キュウ	キョウ	キワ
竇	アナ	トウ	トク
竈	カマ/ガマ	カマド	ソウ	ヘッツイ
竉	アナ	ル	ロウ
竊	セツ	ヌス	ヒソ
立	タ/タチア/タチイ/タチノ/タチハ/ダ	タチ/ダチ	タチハ/タチバ	タツ/タッ/タヅ/ダツ	タテ/ダテ	ツイ	リットル	リツ/リッ	リュウ
竌	ショ	タダ
竍	デカリットル
竎	ノボ	フ	フウ
竏	キロリットル
竑	オウ	コウ	ヒロ
竒	アヤ	キ	ク	クシ	メズラ
竓	ミリリットル
竕	デシリットル
站	タン
竚	タタズ	チョ
竛	イク	リョウ	レイ
竜	イセ	タツ/タッ	リウ	リュウ	リョウ	ロウ
竝	ナ	ナラ	ヘイ	ホウ
竟	オワ	キョウ	ケイ	ツイニ	ワタ
章	アキ	アキラ	アヤ	ショウ	ハジメ	フミ
竡	ヘクトリットル
竢	シ	マツ
竣	オワ	シュン	ドウ	ワラベ	ワラワ
童	ドウ	パ	ワラベ	ワラワ
竦	オソ	ショウ	スク	ツツシ
竨	タカクケ	チョウ
竩	ギ	ヨイ	ヨシミ
竪	コドモ	ジュ	タ	タテ
竫	ジョウ	セイ	ヤス
竬	ク	タ
竭	ケツ	ツク
端	タダシ	タン	ハ/バ/パ	ハシ/ハジ/バシ/パシ	ハシタ	ハタ/バタ	ハナ/バナ/パナ	ミズ
竰	センチリットル
竱	セン	タン	テン	ヒト	ヒトシク
竴	シュン	ヨロコ
競	カイ	キオ	キソ/キソウ	キョウ	クラ/クラベ	ケイ	セ/セリ/ゼ	セリ/ゼリ	ワタナベ
竸	キソ	キョウ	クラ	ケイ	セ
竹	タカ	タケ/ダケ	チク/チッ
竺	アツシ	ジク	チク	トク
竻	キン	コン	スジ	ロク
竽	ウ	フエ
竾	シ	チ	フエ
竿	カン	サオ/ザオ
笂	ウツボ
笄	ケイ	コウガイ
笆	ハ
笇	カゾ	サン
笈	オイ	キュウ
笊	ザル	ス	ソウ
笋	イン	シュン/ジュン	タカンナ	タケノコ
笏	コツ	シャク
笑	エ	エミ	ショウ	ワラ/ワライ
笔	ヒツ	フデ
笘	セン	チョウ
笙	ショウ	ソウ	フエ
笛	ウ	テキ	フエ/ブエ
笞	シモト	チ	ムチ
笟	コ	タガ
笠	カサ/カザ/ガサ	リュウ
笣	キョウ	コウ	ヒョウ	ホウ
笥	ケ/ゲ	シ	ス	ハコ
符	フ/プ
笧	サク	シガラ
笨	アラ	ガサ	ホン
笩	トビア	ハイ
笪	ウ	タチ	タツ	タン
笫	シ	シチ	シツ	ユカ
第	ダイ	テイ
笭	チリヨケ	リョウ	レイ
笮	サク	シャク	セマ
笯	ダ	トリカゴ	ド	ナ	ヌ
笰	オオ	ヒ	フチ	フツ
笱	ク	コウ
笳	アシブエ	カ
笴	カ	カン	コウ	ヤガラ
笵	ノリ	ハン	ボン
笶	シ
笹	サ/ザ	サキ	ササ	ザサ	シノ	ジネ
笽	ザル	ソウケ	ミン
笿	タバ	ツカ	ラク	ワンカゴ
筀	ケ	ケイ	タケ
筁	カイコノ	キョク	コク
筅	ササラ	セン
筆	クシ	ヒツ/ヒッ/ピツ	フデ
筇	キョウ	ク	タケ
筈	カツ	ハズ	ヤハズ
等	ト	トウ/ドウ	ナド	ヒ	ヒト	ヒトシ	ラ
筋	キン	スジ
筌	ウエ	ウケ	セン
筍	イン	シュン/ジュン	タカンナ	タケノコ
筎	ジョ	ニョ	マキハダ
筏	イカダ	ハツ/バツ	ボチ
筐	カゴ	カタミ/ガタミ	キョウ	ハコ
筑	チク/チッ	ツク/ヅク	ヅキ
筒	ツツ/ヅツ	トウ/ドウ
答	コタ/ゴタ	コタエ	トウ/ドウ
筕	ギョウ	グウ	コウ	タケムシロ
策	サク
筝	コト	ショウ	ソウ
筠	イン	ウン	タケ
筤	カゴ	リョウ	ロウ
筥	キョ	ハコ
筦	カン	クダ	フエ
筧	カケイ	カケヒ	ケン
筩	ズ	トウ	ユ	ヨウ
筪	ギョウ	コウ	タケ
筬	オサ	セイ
筭	カゾ	サン	ソロバン
筮	ウラナ	セイ/ゼイ	メドギ
筯	ジョ	チョ	ハシ
筰	サク	シャク
筱	シノ	ショウ	ゾウ
筲	カゴ	サク	ショウ	ソウ
筳	イトクダ	ジョウ	チョウ	テイ
筴	キョウ	サク	メドギ
筵	エン	ムシロ
筷	カイ	ハシ
筺	カゴ	カタミ	キョウ	コバコ	ハコ
箄	カゴ	ハイ	ヒ	ビャク	ヘイ	ヘキ
箆	クシ	ノ	ハイ	ヘイ	ヘラ
箇	カ/ガ	コ/ゴ
箉	カイ	ゲ
箋	セン	フダ
箍	コ	タガ
箎	ク	コ	ジ	チ
箏	コト	ショウ	ソウ
箐	ショウ	セイ	セン
箑	オウギ	ショウ	ソウ
箒	シュウ	ソウ	ホウキ/ボウキ
箔	スダレ	ハク/パク
箕	キ	ミ	ミノ
箖	タケ	リン
算	サン/ザン	ソロ
箘	キン
箙	エビラ	フク
箚	サ	サツ	チョウ	トウ
箛	ク	コ	フエ
箜	ク	コウ
箝	カン	クビカセ	ケン	ス	ハサ
箞	ケン	タワ
箟	キン
箠	スイ	タケ
管	カン	クダ	スガ
箥	ハ
箪	タン/ダン	ハコ
箬	ジャク	ジョク	タケノカワ	ニャク	ヒャク
箭	セン	ヤ
箯	タケゴシ	ヘン
箰	イン	シュン	タカンナ	タケノコ
箱	ソウ	ハコ/バコ
箲	ササラ	セン
箴	イマシ	シン	ハリ
箵	ショウ	セイ
箶	コ	タケ
箸	チャク	チョ	ハシ/バシ
箺	シュン	タケ
箻	リツ
箼	オク	シゲ
箽	タケ	ツ	トウ
節	セチ	セッ/ゼッ	セツ/セッ	タカシ	ノット	フシ/ブシ/プシ	ミサオ
篁	コウ	タカムラ
篂	ショウ	セイ
範	ノリ	ハン/パン
篅	ザル	スイ	セン	タン	テン
篆	テン
篇	ヘン/ペン
篈	フ	ホウ
築	キズ	キヅ	チク/チッ	ツイ	ツキ/ヅキ	ツク
篊	グ	コウ	トイ
篋	キョウ	ハコ
篌	コウ	ゴ
篏	アナ	カン	ハ
篔	ウン	エン	タケ
篖	トウ
篗	イトワク	ワク
篙	コウ	サオ
篚	ハコ	ヒ
篛	ジャク	ジョク	タケノカワ	ニャク	ヒャク
篝	カガリ	カガリビ	コウ	フセゴ
篠	ササ/ザサ	シノ	ショウ/ジョウ	スズ	ゾウ	ノ
篤	アツ	アツシ	トク/トッ
篥	リキ	リチ	リツ
篦	ノ	ハイ	ヘイ	ヘラ/ベラ
篨	ジョ	タケムシロ	チョ
篩	サイ	シ	フル	フルイ/ブルイ
篪	シ	チ	フエ
篭	カゴ	コ/ゴ	コモ/ゴモ	ゴメ	ル	ロウ
篲	エ	ケイ	スイ	セイ	ホウキ
篳	ヒチ	ヒツ	マガキ
篴	ジク	チク	チャク	テキ	フエ
篵	ス	ソウ
篶	エン	クロダケ	スズ
篷	トマ	ホウ
篸	サン	シン	ソロワナイ
篹	カタミ	サン	ゼン
篺	イカダ	ハイ	ヒ	ヘン	ベ
篼	カイバオケ	ツ	トウ
篾	ベツ	メチ
簀	サク	ジャク	ス/ズ	セキ
簁	サイ	シ	フル
簂	カク	カタミノモノ	ケ
簃	イ	ジ	チ	ワキベヤ
簄	コ	コウ
簆	オサ	ク	コウ
簇	ソウ	ソク/ゾク	ムラ
簉	シュ	シュウ	ソ
簋	キ
簌	ソク	フル
簍	ル	ロウ
簎	サク	シャク	セキ	ヤス
簏	ハコ	ロク
簑	サ	サイ	ミノ
簒	ウバ	サン	セン
簓	ササラ
簔	サ	サイ	ミノ
簗	ヤナ	リョウ
簙	スゴロク	ハク
簛	シ	フル
簟	タカムシロ	タン	テン
簠	フ
簡	エラ	カン	ケン	フダ
簣	アジカ	キ	モッコ
簥	キョウ
簦	カサ	トウ
簧	コウ	シタ
簨	サン	シュン	ゼン	ヨコギ
簪	カンザシ	サン	シン
簫	ショウ	フエ
簬	タケ	ル	ロ
簱	キ	ハタ
簳	カン	シノ	ヤガラ
簴	キョ	ゴ
簶	ロク
簷	エン	ヒサシ
簸	ハ	ヒ
簹	タケ	トウ
簺	サイ	ソゴ	フダ
簽	カゴ	セン
簾	ス/ズ	スダレ	ミス	レン
簿	ボ
籀	シュウ	ジュ	チュウ	ヨ
籃	カゴ	ラン
籆	イトワク	ワク
籊	チャク	テキ
籌	カズトリ	チュウ	ハカリゴト
籍	セキ
籏	キ	ハタ/バタ
籐	トウ
籑	セン
籒	シュウ	ジュ	チュウ	ヨ
籓	ハン	ホン
籔	ソウ	ヤブ
籕	リュウ
籖	カズトリ	クジ	セン
籘	トウ
籙	ホンバコ	リョク	ロク
籚	エ	カゴ	ル	ロ
籛	サン	セン	タケ
籜	タク	タケノカワ
籝	エイ	カゴ	ハシヅツ	ヨウ
籞	ギョ	ゴ	トメバ
籟	フエ	ライ
籠	カゴ	コ/コメ/ゴ	コモ/ゴモ	ゴメ	モリ	ル	ロウ
籡	シンシ
籣	エビラ	ラン
籤	カズトリ	クジ	セン
籥	フエ	ヤク
籧	キョ	ゴ
籩	タカツキ	ヘン
籬	カキ/ガキ	マガキ	マセ	リ
籭	サイ	シ	フル
籮	ミ	ラ
籰	イキ	イトワク	ヨク	ワク
籲	ヤク	ユ	ヨ
米	アメリカ	コメ	ゴメ	ハ	ベ	ベイ	マイ	マベ	メ	メエトル	ヨ	ヨナ	ヨネ	ヨノ	ヨマ
籵	デカメートル
籹	ジョ	ニョ
籼	ウルチ	セン
籽	シ
籾	モミ
粁	キロメートル
粂	クメ
粃	シイナ	シナ	ヒ
粆	サ	シャ	ショウ
粇	コウ	ヌカ	ムナ
粉	コ	コナ/ゴナ	デシメートル	フン/ブン/プン
粋	イキ	スイ/ズイ
粍	ミリ	ミリメートル
粏	タ	ヌカミソ
粐	コ	ヌカ	ヨネド	ロ
粒	ツブ	リュウ
粔	キョ	ゴ
粕	カス/ガス	ハク
粗	アラ	ソ	ホボ
粘	ネバ	ネン
粛	シュク	スク	ツツシ
粞	コゴメ	サイ	セイ
粟	ア	アワ	サッ	ショク	ソウ	ソク/ゾク	モミ
粠	コウ	スクモ
粡	トウ
粢	シ	シトギ
粤	エツ/エッ	ココニ
粥	イク	カイ	カユ/ガユ	シュク/ジュク	ヒサ
粦	リン
粧	サ	ショウ	メカ	ヨソオ
粨	ヘクトメートル
粫	ウルチ	ジ	メン
粭	スクモ
粮	カテ	リョウ	ロウ
粰	オコシ	カ	カユ	フ	フウ	モミガラ
粱	アワ	リョウ
粲	イイ	サン	ツバラ
粳	ウル	ウルチ	コウ	ヌカ
粶	ハゼコメ	ロク
粷	キク	コク	コナ
粹	イキ	スイ
粺	シラゲヨネ	ハ	ハイ	ベ
粻	カテ	ジョウ	チョウ	トウ
粼	セセラギ	リン
粽	ソウ	チマキ
精	キヨ	キヨシ	クワ	ショウ/ジョウ	シラ/シラゲ	セイ/ゼイ	タダシ
粿	カ	ゲ	シラゲヨネ
糀	コウジ
糂	ジン
糄	コメ	ヘン	ヤキゴメ
糅	カテ	ジュウ	マ
糇	グ	コウ	ホシイイ
糈	カテ	ショ
糉	ソウ	チマキ
糊	コ/ゴ	コツ	ノリ
糍	シ
糎	センチ	センチメートル
糏	コゴメ	セチ	セツ	ソチ	ソツ
糒	ハイ	ビ	ホシイ
糓	コク
糔	シュ	シュウ	シル	ソウ
糕	コウ	コナモチ
糖	トウ
糗	イリゴメ	キュウ	ク	ショウ
糘	スクモ
糙	クロゴメ	ソウ
糚	ショウ	ソウ	ヨソウ
糜	タダ	ビ
糝	コナガキ	サン	シン
糞	クソ/グソ	ババ	フン/プン
糟	カス	コウ	ソウ	ヌカ
糠	コウ	ヌカ
糢	カタ	ノットル	ボ	モ
糦	キ	サケサカナ	シ	ム
糧	カテ	リョウ	ロウ
糩	カイ	ケ	ヌカ
糫	オコシ	カイ	カン	ゲン	モチ
糯	ダ	ナ	モチ	モチゴメ
糲	アラ	クロゴメ	ラツ	レイ
糴	ウ	カイヨネ	セリ	チョウ	テキ
糵	ゲツ
糶	ウリヨネ	セ	セリ	チョウ
糸	イト	シ
糺	アザナ	キュウ	タダ/タダシ/タダス
系	ケイ
糾	アザナ	キュウ	タダ
紀	オサム	キ/ギ	キノ	タダス	トシ	トモ	ノリ	モト
紂	シリガイ	チュウ
紃	シュン	セン	ヒモ
約	ツヅ	ツヅマ	ヤク/ヤッ
紅	アカ	ク/グ	クレ	クレナイ	コウ	ベニ	モミ
紆	ウ	マガ	メグ
紇	ケツ	ゲチ	コツ	ゴチ
紈	カサ	カン	キヌ	シロギヌ	ムスブ
紉	キン	コン	ジン	ナワ	ニン
紊	ビン	ブン	ミダ
紋	アヤ	モン
納	オサ	オサム	オサメ	トウ	ナ	ナッ	ナン	ノ	ノウ	ロ
紏	ツ	トウ
紐	ジュウ	チュウ	ヒモ
紑	アザ	ハイ	フ	フウ
紒	カイ	ケイ	ケチ	ケツ	ムス	ユウ
紓	ショ	ユル
純	アツ	アツシ	キヨシ	ジュン	スミ	ミ	ヤスシ	ヨシ
紕	ヒ
紖	イン	ジン	チン
紗	ウスギヌ	サ	シャ	スズ	タエ
紘	オオヅナ	コウ	ツナ	ツナグ	ヒロ	ヒロシ
紙	カミ/ガミ	シ
級	キュウ	シナ
紛	フン/プン	マガ	マガイ	マギ	マギレ	マグ
紜	ウン	ミダ
紝	ジン	ニン	ハタイト
紞	タン	トン	ヒモ
素	ス	スッ	ソ	モト
紡	ツム	ボウ
索	サク	ヒ
紣	サイ	シュチ	シュツ	スイ
紦	キヌ	ハ
紪	キヌノアヤ	サイ	セイ
紫	サイ	シ	ムラサキ	ユカリ
紬	チュウ	ツム	ツムギ
紭	アミノツナ	カ	ギョウ	コウ
紮	カラゲル	サツ
累	ルイ
細	コマ/ゴマ	コマカ	サイ/ザイ	ホソ/ボソ
紱	ヒモ	フチ	フツ
紲	キズナ	セツ
紳	シン	マコト
紵	チョ
紹	ショウ/ジョウ	ツグ
紺	コン
紼	ツナ	ヒ	フチ	フツ
紽	タ
紾	シン	テン	モト
紿	アザム	タイ
絀	アカ	チュチ	チュツ
絁	シ	ツムギ
終	オ/オワリ	オワ	シュウ/ジュウ	ツイ	バテ
絃	イト	ゲン
組	ク/グ	クミ/グミ	ソ
絅	ケイ	ヒ
絆	キズナ	ツナ	ハン/バン	ホダ	ホダシ
絇	ク	クツカザリ
絈	ツツ	ハ	ハク	バツ	ヘ	ミャク	ミュク	メチ
絋	コウ
経	キョウ/ギョウ	ケイ	タ	タテイト	ツネ	ノブ	ノリ	ハカ	ヘ
絍	ジン	ニン	ハタイト
絎	ク/クケ	クケ/グケ	コウ
絏	セツ
結	ケチ	ケツ/ケッ	ムス/ムスビ	ムスブ	ユ/ユワ	ユイ	ユウ
絑	シュ	チュ
絓	カ	カイ	ゲ	ツムギ	ワ
絖	コウ	ヌメ	ワタ
絗	イトガメグ	コツ	ゴチ
絙	カン	クミヒモ	コウ
絚	コウ
絛	サナダ	ジュウ	ジョウ	トウ
絜	アサ	カツ	キヨ	ケイ	ケチ	ケツ	タバ
絝	ク	コ	ズボン	ハカマ
絞	コウ	シ/シメ/ジ	シボ	シメ/ジメ
絡	カラ/ガラ	ラク
絢	アヤ	ケン	ジュン
絣	カスリ/ガスリ	ホウ
絥	ヒ	フク
給	キイ	キュウ/ギュウ	タ	タマ	タモ
絧	ズ	トウ	ヌノ
絨	ジュウ
絪	イン
絮	ショ/ジョ	ワタ
絰	テツ	デチ
統	オサム	ス	トウ	ノリ	ホビ	ミツル	ムネ
絲	イト	シ
絳	アカ	コウ
絵	エ	カイ
絶	ゼツ/ゼッ	タ/タエ/ダ
絸	キヌ	ケン	マユ
絹	キヌ/ギヌ	ケン
絺	チ	ホソヌノ
絻	バン	ブン	ベン	マン	メン	モフク	モン
絽	リョ	ロ
絿	キビ	キュウ	ク
綁	シバル	ホウ
綂	スベ	トウ	ホビ
綃	キイト	ショウ	ソウ
綅	イト	シン	セン
綆	キョウ	コウ	ツルベナワ	ハン	ヒョイ	ヘイ
綈	タイ	ツムギ	テイ
綉	シュウ	ツ	トウ
綋	オオヅナ	コウ	ツナ
綌	キャク	クズヌノ	ケキ
綍	ヒ	ヒツギナワ	フチ	フツ
綏	スイ	タ	ヤス
綑	オ	コン
經	キョウ	ケイ	タ	タテイト	ツネ	ノリ	ハカ	ヘ
綖	エン	セン
綗	ケイ	ヒ
継	ケイ	ツ/ツギ/ツグ	ツナガ	ママ
続	キョウ	コウ	ショク	ゾク/ゾッ	ツ/ツギ	ツグ	ツヅ/ツヅキ
綛	カスリ	カセ
綜	オサ	ス	ソウ
綝	シン	チン	ト	リン
綞	アヤ	タ
綟	モジ	レイ
綢	チュウ	トウ	マトウ
綣	ケン	ヘソ
綦	アヤギヌ	キ
綧	シュン	ミダ
綪	ショウ	セイ	セン	ソウ
綫	スジ	セン
綬	ジュ	ヒモ
維	イ	コレ	タモツ	ツグ	ユイ	ユキ
綮	ケイ
綯	トウ	ナ/ナイ	ナワ	ヨ
綰	タカ	タガ	ワガ	ワン
綱	コウ	ツナ/ヅナ
網	ア	アミ	ズナ	モウ
綳	タバ	ヒョウ	ホウ	マ
綴	ゲツ	スミ	ツヅ	ツヅリ	テイ	テチ	テツ	ト/トジ
綵	アヤ	アヤギヌ	サイ
綶	カ	クワ	マトウ
綷	サイ	シュチ	シュツ	スイ
綸	イト	カン	リン
綹	イト	リュウ	ル
綺	アヤ	アヤギヌ	キ/ギ
綻	タン	ホコロ
綽	アダ	シナ	シャク	ユル
綾	アヤ	リョウ	リン
綿	ウ	メン	ワタ
緂	アザ	サン	セン	タン
緃	イロギヌ	シュ	ショウ
緄	オビ	コン
緅	シュ	シュウ	ス	ソウ
緆	イ	シャク	セキ	ホソヌノ
緇	クロ	シ
緊	キン	シ
緋	アカ	アケ	ヒ
緌	カンムリノヒモ	ズイ	ニ
緍	コン	サシ	ゼニサシ	ツリイト	ナワ	ビン	ミン
緎	イキ	イク	キョク	コク	ヌイカガリ	ヨク
総	ウサ	ス	スベ	ズサ	ソウ	フサ/ブサ
緑	ミドリ	リョク/リョッ	ロク/ロッ
緒	イトグチ	オ	ショ	チョ	ホ	ヲ
緕	カスリ
緗	アサギ	ショウ	ソウ
緘	カン	ト
緙	カク	キャク	ヌ
線	スジ	セン
緜	ツラ	メン	ワタ
緝	シュウ	ツム
緞	タン	ドン
締	シ/シマ/シメ/ジ	シマ/ジマ	シメ/ジメ	テイ
緡	コン	サシ/ザシ	ゼニサシ	ツリイト	ナワ	ビン	ミン
緢	ビョウ	ボウ	ミョウ
緤	キズナ	セチ	セツ	ツナ
緥	ホ	ホウ	ムツキ
緦	シ	ヌノ
編	ア/アミ	ヘン/ペン
緩	カン	ヒロ	ユル
緪	コウ
緫	ス	スベ	ソウ	フサ
緬	ハル	ベン	メン
緭	イ	ウチヒモ	キ	キヌ	ヒモ
緯	イ	ヌキ	ヨコイト
緱	ク	コウ	ツカ
緲	ビョウ	ミョウ
練	ネ	ネリ	レン
緵	イト	ス	ソウ
緶	ト	ヘン
緹	アカギヌ	タイ	テイ
緺	カ	カイ	ケ	ラ
緻	コマカ	チ
縀	カ	クツ	ゲ
縁	エニシ	エン	ネン	フチ/ブチ/プチ	フチド	ヘリ/ベリ	ユカリ	ヨ	ヨスガ
縄	ジョウ	タダ	ナワ
縅	オド	オドシ
縈	エイ	メグ	ヨウ
縉	サシハサ	シン
縊	イ	エイ	クビ
縋	スガ	ツイ
縐	シュ	シュウ	シュク	ス	チヂミ
縑	キヌ	ケン
縒	サ	シ	ヨ
縕	ウン	オン	フル
縗	サ	サイ	スイ
縛	イマシ	シバ/シバリ	ジバ	バク
縜	イン	ウン	ホソヒモ
縝	アサイト	シン	チン
縞	コウ	シマ/ジマ	シロギヌ
縟	シゲシ	ジョク
縠	コク	チリメン	モジリ
縡	コト	サイ
縢	カガ	カナ	カラ	トウ	ムカバキ
縣	アガタ	カ	ガタ	ケン
縦	ジュウ	タテ	ホシイママ	ヨ
縧	サナダ	ジュウ	ジョウ	トウ
縨	コウ	トバリ	ホロ
縫	ヌ/ヌウ	ヌイ	ホウ
縬	キヌノアヤ	シュク	チヂ	チヂミアヤ
縭	カギ	チ	リ
縮	シュク/シュッ	チヂ/チヂミ
縯	イン	エン	ナガ
縱	ジュウ	タテ
縲	ルイ
縳	ケン	シロギヌ	セン	テン
縵	バン	マン
縶	ショウ	チュウ	ツナ
縷	イト	ル	ロウ
縹	ハナダ	ヒョウ
縺	モツ	レン
縻	キズナ	ビ	ミ
總	サトシ	ス	スベ	ズサ	ソウ	フサ
績	ウ	セキ	ミ
縿	サン	ショウ	セン	ソウ	ハタアシ
繁	シゲ	シゲル	ハン/パン
繃	タバ	ヒョウ	ホウ	マク
繄	イ	エイ	ホコブクロ
繅	クル	ソウ
繆	アヤマ	キュウ	コラ	ビュウ	ボク	マト	リョウ
繇	シタガ	ジュ	チュウ	ユ	ユウ	ヨウ
繊	セン
繋	カ	カカ	ケイ	ツナ	ツナガ	ツナギ
繍	シュウ	ヌイトリ
繎	イトノモツレ	クレナイ	ネン	ビン	モツ
繐	エ	ケイ	サイ	セイ
繒	キヌ	ショウ	ソウ
織	オ	オリ	コオリ	コリ/ゴリ	シキ	ショク/ショッ	ノリ
繕	ゼン	ツクロ/ヅクロ
繖	サン
繘	イチ	イツ	キチ	キツ	ツルベナワ
繙	ハン	ヒモト	ホン
繚	マト	メグ	リョウ
繝	カン	ケン/ゲン
繞	ジョウ	ニョウ	マトウ	マワ	メグ	モトウ
繟	セン	タン	ユル
繡	シュウ	ヌイトリ
繢	オリアマリ	カイ	キ	コツ	ゴチ
繥	キ	タノ	ワラ
繦	キョウ	ゼニサシ	ムツキ
繧	ウン
繩	ジョウ	タダ	ナワ
繪	エ	カイ
繫	カ	カカ	ケイ	ツナ
繭	キヌ	ケン	マユ
繮	キョウ	コウ	タヅナ
繯	カラ	カン	ケン
繰	ク/グ	クリ/グリ	ソウ
繳	カエ	カク	キョウ	ギャク	シャク
繸	スイ	ヒモ
繹	エキ	タズネ	ヌ	ヤク
繻	ウスギヌ	シュ/ジュ
繼	ケイ	ツ	ママ
繽	オオシ	ヒン
繾	キン	ケン	テアツイ	テン
繿	ボロ	ラン
纁	ウスイアカイロ	クン
纂	アツ	サン
纃	カスリ
纆	ナワ	ボク	モク
纇	フシイト	ライ
纈	ケチ	ケツ	シボリ	ブサ
纉	サブ	サン	ツ
纊	コウ	ヌメ	ワタ
續	キョウ	コウ	ショク	ゾク	ツグ	ツヅ	ツヅキ
纍	ツヅ	ライ	ルイ
纎	セン
纏	テン/デン	マツ	マツワ	マト/マトメ	マトイ
纐	コウ	ハナ
纑	ヌノイト	ル	ロ
纒	テン	マツ	マト	マトイ
纓	エイ	ヨウ
纔	サイ	サン/ザン	ヒタタ	ワズ	ワズカ
纕	ウデマクリ	ショウ	ソウ
纖	セン
纘	サブ	サン	ツ
纚	カミヅツミ	サイ	シ	シャ	ツヅ	リ
纛	オニガシラ	トウ	トク	ハタボコ
纜	トモヅナ	ラン
纝	カラ	クロナワ	マト	ルイ
纞	ツヅ	レン
缶	カマ	カン	フ	ベ
缸	カメ	コウ
缺	カ/カケ	ケツ/ケッ	ケン
缻	カマ	カン	フ	ベ
缼	カ	ケツ	ケン
缽	ハチ	ハツ
缾	ビン	ヘイ
缿	グ	コウ	ズ	ゼニガメ	トウ
罃	オウ	ヨウ
罄	キョウ	ケイ	ムナ
罅	カ	ケ	スキ	ヒビ	モタイ
罇	カメ	ソン
罌	エイ	オウ	カメ	ホトギ	モタイ	ヨウ
罍	サカダル	ライ
罎	タン	ドン	ビン
罏	サカダ	ル	ロ
罐	カマ	カン	フ	ベ
网	アミ	アミガシラ	ボウ	モウ	ヨコメ	ヨンカシラ
罒	アミガシラ	ボウ	モウ	ヨコメ	ヨンカシラ
罓	アミガシラ	ボウ	モウ	ヨコメ	ヨンカシラ
罔	アミ	シイ	ナイ	ボウ	モウ
罕	カン	マレ
罘	ウサギアミ	フ
罛	ウオアミ	ク	コ	ロ
罜	アミ	シュ	トク
罝	アミ	シャ	ショ
罟	アミ	コ
罠	アミ	ビン	ミン	ワナ
罡	コウ
罣	カ	カイ	ケ	ケイ
罤	アニ	イサギアミ	コン	ダイ	テイ
罥	カ	ケン
罦	アミ	フ	フウ
罧	リン
罨	アミ	アン	エン
罩	コメ	トウ
罪	ザイ	ツミ
罫	カイ	ケ	ケイ
罭	イキ	キョク	ヨク
置	オ	オキ	オケ	キ/ギ	チ
罰	ハツ/バツ	バチ	バッ
罱	グン	ダン	ナン	ラン
署	ショ
罵	ノノシ	バ
罷	ヒ	マカ	ヤ
罸	ハツ/ハッ/バツ	バチ
罹	カカ	ラ	リ
罽	ウオアミ	ケイ
罾	ソウ
罿	シュ	ショウ	ズ	トウ	ムソウアミ
羀	ウエ	ウケ	ヤナ	リュウ	ル
羂	ケン	ワナ
羃	ベキ
羅	ウスモノ	ラ
羆	シグマ	ヒ	ヒグマ
羇	オモガ	キ	タヅナ	タビ	ツナ	ハ
羈	オモガ	キ	タヅナ	タビ	ツナ	ハ
羊	ヒツジ	ヨ	ヨウ
羋	バ	ビ	マ	ミ	メ
羌	アア	エビス	キョウ
羍	タチ	タツ
美	イ	ウツク	ハル	ビ	ミ	ヨシ	ヨシミ	リ
羏	ウルワ	ヨイ	ヨウ
羐	イザナ	スス	ミチビ	ユ	ユウ
羑	イザナ	スス	ミチビ	ユ	ユウ
羔	コウ	コヒツジ
羖	ク	コ	ヒツジ
羗	アア	エビス	キョウ
羚	カモシカ	リョウ	レイ
羜	コヒツジ	ショ	チョ
羝	オヒツジ	テイ	ラン
羞	シュウ	ススメ	ハ	ハジ
羡	アマリ	イ	ウラヤ	エン	セン
羢	ジョウ	ニュ
羣	グン	ム	ムラ	ムレ
群	グ	グリ	グン	コオ	コオリ	ゴウリ	ム/ムレ	ムラ
羦	カン
羨	アマリ	ウラヤ	エン	セン	トモ
義	ギ	タダシ	チカ	ノリ	ヨシ
羪	ヤシナ	ヨウ	リョウ
羭	ユ
羮	アツモノ	カン	コウ
羯	カツ/カッ	ケツ
羲	キ/ギ
羴	セン	ナマグサ
羶	セン	ナマグサ
羸	ツカ	ヨワ	ルイ
羹	アツモノ	カン	コウ
羼	サン	セン	マジリア
羽	ウ	シュウ	ハ/バ/パ	ハネ/バネ	ワ
羿	ゲイ
翀	ジュ	チュウ	トビア
翁	オ	オウ	オキナ/オギナ	オナ
翃	コウ
翅	シ	ツバサ	ハネ
翆	カワセミ	スイ	ミドリ
翈	コウ	ハネ
翊	ヨク
翌	ヨク
翎	ハネ	リョウ	レイ
翏	リク	リュウ	リョウ	ル
習	シュウ/ジュウ	ジュ	ナラ/ナライ
翔	カ/カケル	カケ/ガケ	ショウ	ト
翕	ア	キュウ
翛	シュク	ショウ	ハヤ	ユ	ユウ
翟	キジ	ケキ	ジャク	タイ	タク
翠	アキラ	カワセミ	スイ	ミドリ
翡	ヒ
翣	ショウ	ソウ	ヒツギカザリ
翥	ア	ショ
翦	セン
翨	アラ	キ	シ
翩	ヒルガ	ヘン/ベン
翫	ガン	モテアソ
翬	キ	ト
翮	カク	ギャク	ハネノモト	リャク	レキ
翯	カク	コク	ツヤガア
翰	カン	ハネ	フデ	フミ	ヤマドリ
翲	トブ	ヒョウ
翳	エイ	カゲ	カザ	キヌガサ	クモ	クモリ
翹	ア	ギョウ	ツマダ
翺	カ	コウ
翻	コボ/コボシ	ハン	ヒルガエ	ホン/ポン
翼	タスク	ツバサ	ヨク
翽	カイ	ケ	ハバタキ
翾	ケン	トブ
翿	トウ	ハタボコ
耀	アカル	カガヤ	ヒカリ	ヨウ
老	エビ	オ	オイ	ビ	フ	ロウ
考	カンガ	コウ	タカ
耄	オイボ	ボ	ボウ	モウ
者	シャ/ジャ	モノ
耆	オイ	キ/ギ	シ
耇	オ	ク	コウ
耈	オ	ク	コウ
耊	テツ	トシヨリ
耋	テツ	トシヨリ
而	シカ	シカルニ	シコ	ジ	スナワチ	ナンジ	ニ
耍	サ	シャ	スバヤ
耎	ゼン	ネン	ヨワ
耏	ジ	ダイ	ナイ	ニ	ホオヒゲ
耐	タ	タイ	タエ
耑	セン	タン	ハシ
耒	キ	ク	スキ	ライ	ライスキ	ルイ
耓	スキノハ	チョウ	テイ
耔	シ	ツチカ
耕	コウ/ゴウ	コオ	タガヤ
耖	ショウ	ソウ	タガヤ
耗	コウ	モウ
耘	ウン	クサギ
耙	ハ
耜	シ	スキ
耝	ショ	スキ	ゾ
耞	カ	カラザオ	ケ
耟	キョ	ゴ	スキノハ
耠	コウ	タガヤ
耡	ジョ	ス	スキ
耤	カ	シャ	ジャク	セキ
耦	グ	グウ	ゴウ
耨	クサギ	クワ	ジュク	ジョク	スキ	ドウ	ヌ
耬	ル	ロウ
耮	ロウ
耰	ウ	ナ	ユウ
耳	ガミ	ジ	ミ	ミミ
耴	ジョウ	チョウ	ニョウ
耵	チョウ	テイ	ミミクソ
耶	カ	ジャ	ヤ
耷	チョウ	トウ
耹	オト	キン	ケン	ゴン
耺	ウン	ミミナリ	ヨウ
耻	チ	ハ	ハジ
耼	タン	ナン	バン	マン
耽	タン	フ/フケ
耾	オウ	コウ	ササヤ
耿	コウ	ヒカリ
聀	ショク	ソク
聄	シン
聆	キク	リョウ	レイ
聊	イササ	イササカ	リョウ
聒	カツ	カマビス
聖	キヨ	キヨシ	サト	サトシ	ショウ	セ	セイ	タカ	タダ	ヒジリ	ヒロ	マサ	ミ
聘	ト	ヘイ	メ
聚	アツ	シュ/ジュ	シュウ/ジュウ
聞	キ/キク/キケ/キコ/ギ	キキ	ブン	モン
聟	セイ	ムコ
聠	ト	ヒョウ	ヘイ
聡	アキ	アキラ	サタ	サト/ザト	サトシ	サトル	ソウ	トシ	ミノル	ミミザト
聢	シカ	シカト	シッカ
聤	ジョウ	テイ	ミミダレ
聦	サト	ソウ	ミミザト
聨	ツラ	レン
聭	キ	トガ	ハジ	ハズカシ
聯	ツラ	レン
聰	アキラ	サト	サトシ	ソウ	ミミザト
聱	キカナイ	ギョウ	ゴウ
聲	コエ	コワ	ショウ	セイ
聳	ショウ	ソビ
聴	キ/ギ	キク	チョウ	テイ	ユル
聵	カイ	ゲ	ツンボ
聶	ササヤ	ショウ/ジョウ	ニョウ
職	ショク/ショッ/ジョク	ソク	モト
聹	ネイ
聽	キ	チョウ	ユル
聾	ツンボ	ミミシイ	ロウ
聿	イチ	イツ	ココニ	フデ	フデヅクリ
肁	ジョウ	チョウ	トウ	ハカ	ハジ
肄	イ	ナラ
肅	シュク	スク	ツツシ
肆	シ	ツラ	ホシイママ	ミセ
肇	ジョウ	タダシ	チョウ	トウ	トシ	ハジ	ハジメ	ハツ
肈	ジョウ	チョウ	トウ	ハカ	ハジ
肉	シシ/ジシ	ニク/ニッ
肋	アバラ	ロク/ロッ
肌	キ	ハダ	ハダエ
肎	ガエンジ	コウ
肓	コウ
肖	アヤカ	ショウ
肘	チュウ	ヒジ
肚	ト	ハラ
肛	コウ
肜	チン	マツリ	ユ	ユウ
肝	カン	キモ/ギモ
肞	サ
股	コ	マタ	モモ
肢	シ
肥	イ	コ/コヤ/ゴ	コイ	コエ/ゴエ	ヒ/ビ/ピ	ヒエ	フト/ブト
肦	タカ	ハン	フン	ワ
肧	ハイ	ハラ	ハラミ
肩	カタ/ガタ	ケン
肪	ボウ
肫	サイ	シュン	スイ
肬	イボ	ユ	ユウ
肭	ジク	トツ
肯	ウナズ	ガエ	ガエンジ	コウ
肱	カイナ	コウ	ヒジ	マルイ
育	イク	ソダ	ハグ	ハグク	ヤス
肴	コウ	サカナ/ザカナ
肸	キチ	キツ	ケチ	ケツ	コチ	ヒロ
肹	キツ	ヒ
肺	ハイ/パイ
胃	イ
胄	カブト	チスジ	チュウ	ヨツギ
胆	イ	キモ/ギモ	タン	マコト
胈	ハイ	ハツ	バチ
背	セ/ゼ	セイ/ゼイ	ソム	ハイ/パイ
胍	カ	ク	ケ	コ
胎	タイ	ハラ
胏	シ
胒	デイ	ハイ
胔	シ	ジャク	セキ
胕	ハラワタ	フ
胖	ナオ	ハン	ヒロ	ユタカ
胗	キン	クチノヒビ	シン
胘	イ	ケン
胙	サク	ソ	ヒモロギ
胚	ハイ	ハラ	ハラミ
胛	カイガラボネ	コウ
胝	アカギレ	チ
胞	ホウ/ボウ/ポウ
胠	キョ	キョウ	コ	コウ	ワキノシタ
胡	ウ	エビス	クル/グル	コ/ゴ	ナンゾ
胤	イン	カズ	タネ/ダネ	ツギ	ツグ
胥	アイ	ショ	ソ	ミ	ミナ
胭	イン	エツ	エン	ノ	ノド	ムセ
胮	ホウ
胯	カ	コ	コウ	マタ
胰	イ	セニク
胱	コウ
胲	オヤユビ	カイ
胳	カク	ギャク	ワキ
胴	ドウ
胶	ギョウ	コウ	コエ	ハギノホネ
胸	キョウ	ムナ	ムネ
胹	ジ	ニ
胺	アチ	アツ	ニオ
胼	ヘン
能	アタ	タカ	ノ	ノウ	ノリ	ヨ	ヨシ
胾	キリミ	シ
脂	アブラ	シ/ジ	ヤニ
脃	セイ	セツ	モロ	ヨワ
脅	オド	オビ	オビヤ	キョウ
脆	セイ/ゼイ	セツ	モロ	ヨワイ
脇	キョウ	ワキ	ワケ
脈	スジ	ミャク/ミャッ
脉	スジ	ミャク
脊	セ	セイ	セキ
脋	オド	オビヤ	キョウ
脖	ホツ	ボチ
脗	ア	ビン	フン	ミン	モン
脘	カン	ゲン
脚	アシ	カク/カッ	キャ/ギャ	キャク/キャッ	シ
脛	ケイ	スネ/ズネ	ハギ
脜	ジュ	ニュ	ヤワ
脞	コマカイ	サ
脠	シオヅ	セン	テン	ヒシオ
脣	クチビル	シン
脤	クチビル	シン	ヒモロギ
脧	サ	サイ	スイ	セン	ヘル
脩	オサ	オサム	シュウ	ナガ	ノブ	ハル	ホジシ
脬	ヒョウ	ホウ	ボウコウ
脯	コジシ	フ	ホ	ホジシ
脰	ウナジ	ズ	トウ
脱	ダツ/ダッ	ヌ/ヌギ/ヌケ
脳	ドウ	ノウ	ノウズル
脵	コ	マタ	モモ
脹	チョウ	ハ	フク/フクラ/ブク
脺	セイ	セツ	モロ	ヨワ
脼	ホジシ	リョウ
脾	ヒ
腅	サカナ	タン	ニク
腆	アツ	テン
腇	ウ	ダイ	ナイ	ワ	ワイ
腊	シャク	セキ	ホジシ	ロウ
腋	エキ	セキ	ワキ
腌	エン	オウ	シオヅ	ヨウ
腎	ジン
腐	クサ/グサ	フ/プ
腑	ハラワタ	フ/プ
腒	キョ	コ	ホジシ
腓	コブラ	コムラ	ヒ	フクラハギ
腔	コウ
腕	ウデ	カイナ	ワン
腗	ヒ
腟	チツ
腠	キメ	ス	ソウ
腡	カ	カイ	ケ	ラ
腥	ショウ	セイ	ナマグサ
腦	ドウ	ノウ	ノウズル
腧	シュ	ユ
腨	コムラ	セン
腩	タン	ドン	ナン
腫	ク	シュ	ショウ	ハ/ハレ/バ	ハレモノ
腭	アゴ	ガク	ハグキ
腮	アゴ	エラ	サイ
腯	コ	トチ	トツ	トン
腰	ウスグ	コシ	ゴシ	ヨウ
腱	キン	ケン
腴	アブラ	コエ	ユ
腷	コモル	ヒョク	ビキ
腸	チョウ	ハラワタ	ワタ
腹	ハラ/バラ/パラ	フク/フッ/プク
腺	セン
腿	タイ	モモ
膀	ホウ/ボウ
膁	アン	ウマイ	カン	ケン
膂	セボネ	リョ	ロ
膃	オツ
膄	カ	シュウ	ニュ	ヤセ
膅	トウ
膆	コ	ソ
膈	カク
膊	ハク	ホジシ
膋	アブ	リョウ
膎	カイ	ゲ	サカナ	ニク	ハダヘ	ホジシ
膏	アブラ	コウ/ゴウ
膐	セボネ	チカラ	リョ	ロ
膓	チョウ	ハラワタ
膕	カク	キョク	コク	ヒカガミ
膖	チュ	チョウ	ハ	ホウ
膘	アバラ	ショウ	ヒョウ
膚	ハダ	ハダエ	フ/プ
膛	トウ
膜	マク
膝	シツ/シッ	ヒザ
膞	キリミ	シュン	セン
膠	キョウ	コウ	ニカワ	ニベ
膢	リュウ	リョ	ル	ロ	ロウ
膣	チツ
膤	セツ	ソリ	タラ	ユキ
膨	フク/ブク	フクラ	ボウ
膩	アブラ	アブラアカ	ジ	ニ
膮	アツモノ	キュウ	キョウ	ク
膰	ハン	ヒモゴリ	ヒモロギ
膲	ショウ	ミノワタ
膳	カシワ	スス	セン/ゼン	ゼ	ソナ	ヨシ
膴	ク	コ	ブ	ホジシ	ム
膵	スイ
膸	ズイ
膺	オウ	ムネ	ヨウ
膻	キモ	タン
膽	キモ	タン
膾	カイ	ケ	ナマス
膿	ウ	ウミ	ドウ	ノウ
臀	シリ	デン	トン
臂	ヒ/ピ	ヒジ
臃	ハレモノ	ヨウ
臅	ショク	ソク
臆	オク/オッ	オクスル	ムネ	ヨク
臈	ロウ
臉	ケン	セン	レン
臊	アブラ	ソウ
臋	シリ	デン	トン
臍	サイ	セイ	ヘソ/ベソ	ホゾ
臎	スイ
臏	ヒン
臑	ジ	ジュ	スネ/ズネ	デイ	ドウ
臓	ゾウ	ハラワタ
臕	ヒョウ
臗	カラダ	カン	コン
臘	ロウ
臙	エン	ノド	ベニ
臚	リョ	ロ
臛	アツモノ	カク	コク
臝	ハダカ	ラ
臞	ク	ヤセ
臟	ゾウ	ハラワタ
臠	キリミ	レン
臡	ゼイ	デイ	ナイ	ヒシオ
臣	オミ	シン/ジン	タカ	ト	トミ	ミ
臤	カタ	カン	キョウ	ケン	コウ
臥	ガ	フ/フシ/フス	フシ/ブシ	フセ/ブセ
臧	ソウ/ゾウ	ヨイ
臨	ノゾ	ミ	リン
自	オノ	オノズ	オノズカ	シ/ジ	ミズカ	ヨリ
臫	キョウ	ツツシ
臬	ゲツ
臭	クサ/グサ	シュウ	ニオ/ニオイ
臰	クサ	シュウ	ニオ
臱	ベン	メン
臲	アヤ	ゲチ	ゲツ
至	イタ	イタリ	イタル	シ/ジ	ノブ	ノリ	ミチ	ヨシ
致	イタ	チ
臵	イタ	カク
臶	セン	ソン	フタタ
臸	イタ	シ	シン	ジツ	チキ	チョク	ニチ
臹	シュ	シュウ	ナラ
臺	ウテナ	タイ/ダイ	ツカサ	ワレ
臻	イタ	シン
臼	ウス	ウスヅ	キュウ	グ
臽	オトシアナ	カン	ゲン	コン
臾	ユ	ヨ	ヨウ
臿	ウスジク	ショウ	ソウ
舀	ク	ヨウ
舁	カ	ヨ
舂	ウスズ	ウスツ	ウスヅ	ショウ	ツ/ツキ
舃	カササギ	サク	シャク	セキ	タク
舅	キュウ	シュウト/ジュウト
與	アズカ	アタ	アタエ	クミ	トモニ	ヨ
興	オキ	オコ	オコッ	キョウ	コウ/ゴウ	トモ
舉	ア	キョ	コゾ
舊	キュウ	フル	モト
舌	シタ/ジタ	ゼツ/ゼッ
舍	シャ	セキ	トネ	ヤド
舎	サ	シャ/ジャ	セキ	トリ	ヤ	ヤド
舏	キュウ	ク	ナメトル
舐	シ	ナ/ナメ	ネブ
舒	ショ/ジョ	ノ
舓	シ	ナ	ネブ
舔	テン	ナ
舖	ホ
舗	キ	ホ/ポ
舘	カン	タチ/ダチ	タテ/ダテ	ヤカタ
舙	カン	クウ	ゲ	タバカ
舚	テン
舛	セン	ソム	ブ	マイ	マス
舜	シュン	ミツ
舝	カツ	クサビ	ゲチ
舞	フ	ブ	マ	マイ
舟	シュウ/ジュウ	フナ/ブナ	フネ/ブネ
舡	コウ	セン	フネ
舢	サン
舨	ハン
舩	セン	フナ	フネ
航	コウ	ワタ	ワタル
舫	ホウ/ボウ	モヤ	モヤイブネ
般	ハン/パン
舮	トモ	ヘサキ	ロ
舲	コブネ	リョウ	レイ
舳	ジク	チク	チュウ	トモ	ヘ	ヘサキ
舴	サク	シャク	タク	チャク
舵	カジ	タ/ダ
舶	ハク/パク
舷	ゲン	フナバタ	フナベリ
舸	カ	フネ
船	セン	フ	フナ/ブナ	フネ/ブネ
舺	ギョウ	コウ	フネ
艀	ハシケ	フ
艃	リ
艄	ショウ	ソウ	トモ
艅	ヨ
艆	フナバタ	フネ	ロウ
艇	テイ
艋	フネ	ボウ	ミョウ	モウ
艎	オウ	コウ	フネ
艏	オウ	シュウ	フネ
艑	ヘン
艖	コブネ	サ	サイ	シャ	セ	フネ
艘	シュウ	ショウ	ソウ	フネ
艙	ソウ
艚	ソウ
艜	タイ
艝	ソリ
艟	イクサブネ	ショウ	トウ/ドウ
艠	トウ	ヨフネ
艢	ショウ	ゾウ	トモ	ホバシラ	ロ
艣	カイ	ヤグラ	ロ
艤	ギ	フナヨソオイ
艦	カン
艧	フネ	ワク
艨	イクサブネ	ボウ	モウ
艪	カイ	ヤグラ	ロ
艫	トモ	ヘサキ	ロ
艭	ソウ
艮	ウシトラ	コン/ゴン	ネヅクリ
良	イ	ジ	ナガ	ハジメ	マコト	ヨ	ヨシ	ラ	リョ	リョウ	ロウ
艱	カタ	カン	ケン	ナヤ
色	イロ/イロア	シカ	シキ/ジキ	シコ	ショク
艴	オコ	ハイ	フチ	フツ	ホツ
艶	アデ	エン	ツヤ	ナマ	モロ	ヨシ
艷	アデ	エン	ツヤ	ナマ	ヨシ
艸	クサ	クサカンムリ	ソウ	ソウコウ
艻	キョク	ナツメ	ユビノマタ	ロク
艽	アレノ	キ	キュウ	グ
艾	アイ	オサ	カ	カイ	ゲイ	モグサ	ヨモギ
艿	ジ	ジョウ	ニ	ニョウ
芀	ショウ	チョウ
芁	コウ
芃	サカン	フウ	ブ	ホウ
芄	カン	ガガイモ
芇	ア	ジゴ	バン	ベン	マン	メン
芉	カイ	カン	ハトムギ
芊	シゲ	セン
芋	イモ	ウ
芍	シャク
芎	キュウ	ク
芑	キ	チサ
芒	コウ	ススキ	ノギ	ノゲ	ボウ	モウ
芔	キ	クサ	ケ
芖	オサ	チ
芘	ヒ
芙	ハス	フ
芚	チュン	トン
芛	イ	シュツ	シュン	ジュチ
芝	コゲ	シ/ジ	シハ	シバ
芟	カ	サン	セン
芠	ブン	モン	ユキノシタ
芡	ケン
芣	サカン	フ	フウ
芤	ク	コウ	ネギ
芥	アクタ	カイ/ガイ	カラシ	ケ/ゲ	ゴミ
芦	ア	アシ	ヨシ	ロ
芧	ショ	チョ	ミクリ	ヨ
芨	キュウ	コウ	ソクズ
芩	キン	ケン	ゴン	ジシバリ
芪	キ	シ	チ	ハナスゲ
芫	ガン	ゲン
芬	カオリ	コウバ	フン/プン
芭	ハ/バ
芮	ゼイ	ゼツ	ネイ	ネチ
芯	シン
芰	キ	ヒシ
花	カ/ガ	ケ/ゲ	ハナ/バナ/パナ	ワ
芲	カ	ケ	ハナ
芳	オ	カオル	カグワ	カンバ	コウ	ハ/バ	ホ	ホウ/ボウ/ポウ	ミチ	ヤス	ヨシ
芴	コチ	コツ	ブツ	モチ
芷	クサ	シ
芸	ウ	ウン	キ/ギ	ゲ	ゲイ	ナリ	ノリ	ワザ
芹	キン	セイ	セリ/ゼリ	ヨシ
芺	アザミ	オウ	ヨウ
芻	シュウ	ス	スウ	マグサ
芼	ハビコ	ヒロ	ボウ	モウ
芽	ガ	ジ	メ	メグ
芾	ハイ	ヒ	フチ	フツ
芿	ジョウ	ニョウ
苅	カ	カイ/ガイ	カリ/ガリ	カル	カン
苆	スサ	ツタ
苐	イ	ダイ	ツバナ	テイ
苑	アヤ	ウ	エン	オン	ソノ/ゾノ
苒	ゼン
苓	ミミナグサ	リョウ	レイ
苔	コケ/ゴケ	コケラ	タイ
苕	エンドウ	ショウ	チョウ
苗	ナエ	ナワ	ネイ	ノラ	ビョウ	ミウ	ミツ	ミョウ
苙	キュウ	リュウ
苚	ユ	ヨウ
苛	イジ/イジメ	イラ	イラダ	カ	カライ	コマカイ	サイナ
苜	ボク	モク
苞	ツト/ヅト	ヒョウ	ホウ
苟	イヤシク	ク	コウ
苠	オオ	ビン	ミン
苡	イ	クサ	シ	ワ
苢	イ	クサ	シ	ワ
苣	キョ	チシャ
苤	ヒ
若	ゴト	シ	ジャク/ジャッ	ニャ	ニャク	モ	ワカ/ワカヤ/ワガ	ワク	ワコ
苦	ク/グ	クル/グル	ニガ
苧	オ	カラムシ	カランシ	チョ
苨	ツリガネソウ	デイ	ナイ
苪	アキ	ヒョウ	ヘイ
苫	セン	トマ
苭	ヨウ
苯	ホン
英	ア	アイ	イギリス	エ	エイ	スグル	タケシ	ハナ	ハナブサ	ヒ	ヒデ	ヨシ	ラ
苳	トウ	フキ
苴	アサ	サ	シャ	ショ	ソ	ツト
苶	ジョウ	ツカ	デツ	ニョウ	ネチ
苷	カン	コン
苹	ビョウ	ヘイ	ホ	ホウ
苺	イチゴ	バイ	マイ
苻	フ
苽	コ	コモ	マコモ
苾	カオ	ヒツ	ビチ	ヘツ
茀	ヒ	フサ	フツ	ブチ	ホツ	ボチ
茁	キチ	キツ	サツ	セチ	メバ
茂	ウムサ	キ	シ	シゲ/シゲル	ツトム	ム	モ	モテ
范	イガタ	ハン
茄	カ	ナ	ナス
茅	カヤ/ガヤ	ジ	チ/ヂ	チガヤ	ボウ	ミョウ
茆	エン	カヤ	ソノ	ヌナワ	ボウ
茇	ネ	ハイ	ハツ	バチ	フチ	フツ
茈	サイ	シ	ジュ	ムラサキ
茉	バツ	マ	マツ	ミ
茊	ココ	シ
茋	シ	ツリガネソウ
茎	キョウ	クキ/グキ	ケイ
茖	カク
茗	チャ	ミョウ	メイ
茘	オオニラ	リ	レイ	レン
茛	ケン	コン	トリカブト
茜	アカネ	セン
茝	サイ	シ	セイ	ヨロイグサ
茞	シン
茟	アカザ	イチ	イツ	エ	ツボミ	ヒツ	ワイ
茡	ウ	シ
茢	アシノホ	レイ	レチ	レツ
茣	ゴ
茨	アシ	イバラ	エバラ	カヤ	クサブキ	シ/ジ	バラ	マツ/マッ	マン
茫	トオ	ボウ
茬	シ	シゲ
茭	キャク	キョウ	ケキ	コウ	マグサ
茮	ショウ	ナルハジカミ	ノウ
茯	ヒ/ビ	フク/ブク
茰	ユ
茱	シュ
茲	ココ	シ/ジ
茳	コウ
茴	ウイ	カイ
茵	イン	シトネ
茶	サ	チャ/ヂャ	チヤ
茷	シゲ	ハイ	ヒツ	ホチ
茸	キノコ	シゲ	ジョウ	タケ/ダケ	ニュ
茹	ウ	ジョ	ニョ	ユ/ユデ	ユダ
茺	シュ	シュウ
茼	シュンギク	ズ	トウ
茽	ジユ	チュウ	ムラ
荀	シュン/ジュン
荂	カ	ク	ケ	ハナ	フ
荃	カラシアエ	サツ	セチ	セツ	セン	ソン
荄	カイ	ネ
荅	アズキ	コタ	トウ
荇	ギョウ	コウ	ハナジュンサイ
草	クサ/クザ/グサ	ソ	ソウ/ゾウ	ヤ
荊	イバラ	ケイ
荍	キョウ	シュ	シュウ	ゼニアオイ
荎	ジ	ジチ	チ	チツ	テツ	デチ
荏	エ	ジン	ニン
荐	シキリニ	セン
荑	イ	ダイ	ツバナ	テイ
荒	ア/アレ	アラ	コウ	スサ	ラ
荓	ビョウ	ヘイ
荔	オオニラ	リ	レイ	レン
荕	キン	ホネ
荖	キンマ	ハイ	ホウ	ロウ
荗	ショク	ジキ
荘	オゴソ	ショウ/ジョウ	ソ	ソウ	チャン	ホウキ
荰	ズ	ト
荳	ズ	トウ	マメ
荵	シノブ	ジン	ニン
荷	カ/ガ	ニ	ハス	リ
荸	ホツ	ボチ
荻	オオギ	オギ	テキ
荼	ズ	タ/ダ	ト	ニガナ
荽	イ	スイ	ニ
荿	ジョウ	セイ
莀	シン	ドウ	ノウ
莂	ウツシウ	タネヲマ	ヘチ	ヘツ
莄	キョウ	コウ
莅	ツ	ノゾ	ノゾキ	リ	ルイ	レイ
莆	フ	ホ
莇	アサガラ	アザミ	ジョ
莉	ライ	リ	レイ
莊	オゴソ	ショウ	ソウ	チャン	ホウキ
莍	キク	キュウ	グ
莎	サ	シャ	ハマスゲ
莒	イモ	キョ	コ
莓	イチゴ	バイ	マイ
莔	キツ	キョウ	コチ	テイ	ハハグリ	ボウ	ミョウ	モウ
莕	ギョウ	コウ	ハナジュンサイ
莖	キョウ	クキ	ケイ
莘	シン
莙	ウン	キン	クン	モ
莚	エン	ムシロ
莛	クキ	ジョウ	テイ
莜	クサトリ	ジュク	ジョウ	チョウ	テキ
莝	キリワラ	サ
莞	イ	カン	フトイ
莟	カン/ガン	ツボミ
莠	ハグサ	ユウ
莢	キョウ	サヤ
莦	ショウ	ソウ	ミダ
莧	カン	ケン	ヒユ
莨	タバコ	ロウ
莩	ヒョウ	フ
莪	ガ
莫	クレ	ナイ	ナカ	ナシ	バク/バッ	ボ	マク	モ
莬	バン	ブン	ベン	マン	メン	モン
莭	セチ	セツ	フシ
莱	アカザ	アワチ	コウガイ	ライ	リ
莵	ウサギ	ツ	ト
莽	クサ	ボウ	モウ
莾	クサ	ボウ	モウ
莿	シ	シャク	セキ	トゲ
菀	ウチ	ウツ	ウン	エン	オン	ソノ	ツ
菁	ショウ	セイ
菅	カン	ケン	ス	スガ	スゲ	スゴ
菇	カラスウリ	ク	コ
菉	カリヤス	リョク	ロク
菊	キク/キッ/ギク
菌	キノコ	キン
菎	コン
菏	カ	クサ
菐	ホク	ワズラワ
菑	アレチ	サイ	シ
菓	カ/ガ
菔	ダイコン	フク	ホク
菖	ショウ
菘	シュウ	スウ	スズナ
菜	サイ/ザイ	ナ	ヨウ
菝	ハツ	バチ
菟	ウ	ウサギ	ツ	ト/ド
菠	ハ	ホ	ホウレンソウ
菨	アサギ	ショウ
菩	ボ
菪	オニヒルグサ	トウ
菫	キン	スミレ
華	カ/ガ	ケ/ゲ	ハナ/バナ	ワ
菰	コ	コモ	マコモ
菱	ヒシ/ビシ	リョウ
菲	ウス	ヒ
菴	アン	イオ	イオリ
菶	フ	ホウ	ボ
菷	シュウ	ソウ	ホウキ
菸	エン	オン	ヨ
菹	シャ	ショ	ツケモノ
菻	リン
菼	オギ	タン
菽	シュク	マメ
萁	カイ	キ	マメガラ
萃	アツ	サイ	スイ
萄	トウ/ドウ
萆	ハツ	バチ	ヒ	ヘイ
萇	チョウ
萊	アカザ	アレワ	コウガイ	ライ	リ
萋	サイ	セイ
萌	キザ	キザシ	ホウ	メグ	メバエ	モ	モエ
萍	ウキクサ	ヒョウ	ヘイ
萎	イ	シオ	シナ	シボ	ナ/ナエ
萏	タン	ドン	ハナ
萑	オギ	カン	スイ
萓	ギ
萕	ザイ	セイ	トトノ	ナヅナ	ヒト
萙	クタビレル
萠	キザ	ホウ	メグム	メバエ	モ	モエ
萢	ヤチ	ヤラ
萩	シュウ	ハ	ハギ
萪	カ
萬	カズ	バン	マ	マン	ユル	ヨシ	ヨロズ
萯	カラスウリ	ハイ	フ	フウ
萱	カ	カヤ/ガヤ	カンゾウ	ケン
萵	ワ
萸	ユ
萹	ニワヤナギ	ヘン
萼	ウテナ	ガク	ハナブサ
落	オ/オト	オチ	オトシ	オトス	ラク/ラッ
葅	シャ	ショ	ツケモノ
葆	シ	ホ	ホウ
葇	ジュウ	ニュ
葈	カラムシ	シ
葉	ハ/バ/パ	ヨ	ヨウ	ワ
葊	アン	イオ	イオリ
葍	ヒルガオ	フク
葎	ツ	ムグラ	リツ
葏	シゲ	ショウ	シン	セイ	セン
葑	カブラ	フ	フウ	ホウ
葒	オオタデ	グ	コウ
葖	ダイコン	トチ	トツ
著	アラ	アラワ	イチジル	シル	チャク	チョ
葘	アレチ	サイ	シ
葙	ショウ	ソウ	ノゲイトウ
葚	アテギ	クワノミ	サワラ	シン	チン
葛	カ	カズ	カズラ	カチ	カツ/カッ	カツラ	クズ	ツヅラ
葜	カツ	クサ
葠	シン	セン	チョウセンニンジン	ニンジン
葡	ブ	ホ/ポ
葢	オオ	カイ/ガイ	カコウ	カサ	ケダ	コウ	フタ
董	タダ	タダシ	トウ
葤	ジュウ	チュウ	ツツ	ツト
葥	キイチゴ	セン
葦	アシ	イ	シオ	シナ	シボ	ナ	ヨシ
葧	シロヨモギ	ホツ	ボチ
葩	ハ/パ	ハナ
葪	アザミ	カイ	キ	ケ	ケイ	サ	トゲ
葫	コ
葬	ソウ	ハフリ	ホウム
葭	アシ	カ	カヤ	ヨシ
葮	タン/ダン	ムクゲ
葯	ヤク
葰	サ	シュン	ショウガ	スイ	セ
葱	ソウ	ネギ
葳	イ
葴	カン	ケン	シン	ヤマアイ
葵	アオイ	キ	ケ	マモル
葶	イヌナズナ	ジョウ	チョウ	テイ
葷	クン
葸	サイ	シ	ヨイ
葹	オナモミ	シ
葺	アシ	シュウ	フ/ブ	フキ/ブキ
葼	コエダ	ス	ソウ
葽	ヨウ
蒁	イチ	イツ	シュツ	ジュチ	リチ	リツ
蒂	タイ	テイ	ヘタ
蒄	カン
蒅	スクモ
蒋	ショウ	ソウ	ハゲ	マコモ
蒐	アカネ	アツ	シュウ
蒒	コウボウムギ	シ
蒓	シュン	ヌナワ
蒔	ウ	シ/ジ	マ/マク	マイ	マカ	マキ
蒕	ウン
蒙	オオ	クラ	コウム	ボウ	モウ
蒜	サン	ニンニク	ノビル	ヒル
蒞	ツ	ノゾ	リ	ルイ	レイ
蒟	ク	コン/ゴン
蒡	ホウ/ボウ
蒦	カク	キャク	ノリ	ハカリ	モノサシ	ヤク	ワク
蒨	アカネ	セン
蒩	シャ	ショ	ソ
蒪	ハク	ホク
蒭	シュウ	ス	スウ	マグサ
蒯	カイ	ケ
蒱	ブ	ホ
蒲	カバ	カバノ	カマ/ガマ	ガワ	フ/ブ	ホ/ボ
蒴	サク	ソクズ
蒸	ジョウ	セイ	フ/フカ	ム/ムシ
蒹	オギ	ケン
蒺	キ	シツ	ショク	ジ	ジチ	ハマビシ
蒻	ジャク	ニャク
蒼	アオ	アオイ	ソウ
蒽	オン
蒾	ガマズミ	ベイ	メイ
蒿	コウ	ヨモギ
蓀	ソン
蓁	シン
蓂	ベイ	ベキ	ミョウ	メイ
蓄	タクワ	チク/チッ
蓆	セキ	ムシロ
蓇	コチ	コツ
蓈	イヌアワ	コウ	ロウ
蓉	ハス	ヨ	ヨウ
蓊	オウ	トウ
蓋	オオ	カイ/ガイ	カコウ	カサ	ケダ	コウ	フタ/ブタ
蓌	イツワ	サ	サイ	シャ	スイ
蓍	シ	メドギ
蓏	ウリ	クサノミ	ラ
蓐	シトネ	ジョク	ニク
蓑	サ	サイ	ミノ
蓓	ツボミ	ハイ
蓖	ヒ	ヘイ
蓙	ゴザ	ザ
蓚	シュウ
蓜	ハイ
蓧	シノ	ショウ	チョウ
蓪	アケビ	ツ	トウ
蓬	ブ	ホウ	ヨモギ
蓮	ハス/バス	ハチス	レン
蓯	カブラ	シュ	ショウ	ス	ソウ
蓰	シ
蓱	ウキクサ	ヒョウ	ヘイ
蓲	ウ	キュウ	ク	シュ	ヌナワ
蓴	シュン/ジュン	ヌナワ
蓷	スイ	タイ	ツイ	メハジキ
蓺	ゲイ
蓻	キク	シュウ	ジョウ	ニョウ
蓼	シン	タテ	タデ	リク	リョウ
蓽	ヒチ	ヒツ	マメ
蓿	シュク
蔀	シトミ/ジトミ	ダ	ダン	ブ	ホウ
蔂	モッコ	ラ	ライ	ルイ
蔃	キョウ	ゴウ
蔆	ヒシ	リョウ
蔇	キ	キケ
蔌	ス	ソウ	ソク	ナ	ヤサイ
蔎	カンバ	サツ	セチ	セツ
蔐	オギ	テキ
蔑	クライ	サゲス	ナイガシ	ナイガシロ	ナミ	ベツ/ベッ
蔓	ツル/ヅル	ハビコ	バン	マン
蔔	フク	ホク
蔕	タイ	テイ	ヘタ	ホゾ
蔗	サトウキビ	シャ	ショ
蔘	サン	シン
蔚	イ	ウチ	ウツ/ウッ	オトコヨモギ
蔜	ゴウ	ハコベ
蔞	ク	ヨモギ	リュウ	ル	ロウ
蔟	ソウ	ゾク	マブシ
蔡	サイ
蔢	ハ
蔣	ショウ	ソウ	ハゲ	マコモ
蔤	ビツ	ミチ	ミツ
蔥	ソウ	ネギ
蔦	タツ	チョウ	ツタ/ヅタ
蔧	スイ	セイ	ホウキグサ
蔪	サン	セン	ツツ
蔫	エン	オン	シボ
蔬	アオモノ	ショ	ソ
蔭	イン	オン	カゲ
蔯	カワラヨモギ	ジン	チン
蔲	ク	コウ
蔳	アカネ	セン
蔴	アサ	マ	マア
蔵	オサ	カク	クラ/グラ	クラシ	クラン	クロウ	サシ	ザ	ソウ/ゾウ	ロウ
蔶	サク	ジャク	ス	スノコ	セキ
蔽	オオ	フツ	ヘイ/ペイ	ヘツ
蔿	イ	カ	ケ
蕀	キョク
蕁	ジン	タン
蕃	シゲ	シゲル	ハン/バン	バ
蕆	イマシ	テン
蕈	キノコ	シン/ジン	タケ
蕉	ショウ
蕊	シベ	ズイ
蕋	シベ	ズイ
蕎	キョウ	ソバ
蕏	チョ
蕐	カ	ケ	ハナ
蕑	カン	ゲン	フジバカマ
蕒	ノゲシ	バイ	メイ
蕓	アブラナ	ウン
蕕	ユ	ユウ
蕖	オヤイモ	キョ	ゴ
蕗	フキ	ル	ロ
蕘	キコリ	ジョウ	タキギ
蕙	エ	カオリグサ	ケイ
蕚	ウテナ	ガク
蕜	イタ	カナ	ヒ
蕝	サイ	セイ	セチ	セツ
蕞	サイ	セチ	セツ
蕟	ハイ	ヒイ	ヒツ	ホチ
蕠	ジョ	ニョ
蕡	シゲ	ハン	フン	ボン
蕢	ア	カイ	キ	ケ
蕣	アサガオ	シュン	ムクゲ
蕤	ショウ	スイ	ソウ	ニ
蕨	ケツ	ワラビ
蕩	ウゴ	トウ	トロ
蕪	アレル	カブ	カブラ	ブ	ム
蕫	ズ	ツ	トウ
蕭	ショウ	ヨモギ
蕯	リュウ	ル	ロウ
蕷	イモ	ヨ
蕹	アツ	ユ	ヨウ
蕺	シュウ	ショウ	ドクダミ
蕻	ク	コウ	シゲ
蕽	ドウ	ヌ	ノウ
蕾	ツボ	ツボミ	ライ
蕿	カヤ	カンゾウ	ケン
薀	ウン	オン	タクワ	ツ
薁	イク	オウ	ニワウメ
薄	ウス/ウスラ	ウスキ	ススキ	ハク/ハッ/バク
薅	クキヲト	コウ
薆	アイ	カク	キ	ケ
薇	ゼンマイ	ビ	ラ
薈	カイ	ワイ
薉	ア	エ	ワイ
薊	アザミ	カイ	キ	ケ	ケイ	サク	トゲ
薋	シ	シゲ
薌	キョウ	コウ	コクモツ
薏	イ	オク	ヨク
薐	ホウレンソウ	ロウ
薑	キョウ	コウ	ハジカミ
薓	シン	セン	チョウセンニンジン	ニンジン
薔	ショウ	ショク	ソウ	バ	ミズタデ
薗	エン	オン	ソノ	ゾノ
薘	オオバコ	タツ	ダチ
薙	カ	チ	テイ	ナ	ナギ
薛	セツ
薜	ヘイ
薝	セン	タン
薟	ケン	コン	ヤブカラシ	レン
薠	ハマスゲ	ハン	ボン
薢	カイ	ケ
薤	カイ	ニラ	ラッキョウ
薥	ショク	ゾク	チク	チョク	レンゲツツジ
薦	コモ/ゴモ	スス	セン
薧	コウ	ハカバ
薨	コウ	ミマカ
薩	サチ	サツ/サッ/ザツ
薪	シン	タキギ	マキ
薫	カオ	カオリ	カオル	カホ	カホル	クニ	クユ	クン	シゲ	タ/タキ	ニホ	ノブ	ヨシ
薬	クスリ/グスリ	ミ	ヤク/ヤッ
薭	ハイ	ヒ	ヒエ
薮	ソウ	ヤブ
薯	イモ	ショ/ジョ
薴	ドウ	ニョウ	ノウ	ミダ
薶	ウズ	バイ	マイ	リ
薷	キクラゲ	ジュ	ジュウ	ニュ
薸	ウキグサ	ヒョウ
薹	アブラナ	タイ	トウ
薺	ザイ	セイ	トトノ	ナズナ	ヒト
薼	カワラヨモギ	ジン	チン
薽	ケン	シン	ヤブタバコ
薾	サ	シ	デイ	ナイ	ニ
薿	ギ	ギョク	ゴク	シゲ
藁	コウ	ワラ
藂	クサムラ	ス	ソウ	ムラ
藇	ウツク	ショ	ヨ
藉	カリ	シャ	ジャク	セキ/ゼキ	フ
藊	フジマメ	ヘン
藋	アオアカギ	ジョウ	タク	チョウ
藍	アイ	ラン
藎	コブナグサ	シン
藏	オサ	カク	クラ	ソウ/ゾウ
藐	カロ	トオ	バク	ビョウ
藕	グ	グウ	ゴウ	ハスノネ
藘	リョ	ロ
藚	オモダカ	ショク	ゾク
藜	アカザ	レイ
藝	ウ	ウン	ゲイ	ノリ	ワザ
藟	カズラ	フジカズラ	ラ	リュウ	ルイ
藠	キョウ	ラッキヨウ
藤	ゾウ	ト/ド	トウ/ドウ	フジ	フジュ
藥	クスリ	ヤク
藦	バ	マ
藨	キョウ	ヒョウ	ホウ	マメ
藩	ハン/パン
藪	ソウ	ヤブ
藭	キュウ	ク	センキュウ
藳	コウ	シタガキ	ワラ
藶	リャク	レキ
藷	イモ	ショ/ジョ
藹	アイ	シゲル
藺	イ	イノ	リン
藻	ソウ	モ
藼	カヤ	カンゾウ	ケン
藾	ライ
藿	カク	スイ
蘀	オチバ	ジャク	タク
蘂	シベ	ズイ
蘄	キ	キン	ケ	ゴン
蘅	ギョウ	コウ
蘆	アシ	ヨシ	ロ
蘇	ス	ソ	ヨミガエ
蘊	ウン	ツ
蘋	ウキクサ	ヒン/ピン
蘍	カオ	クン
蘎	キ
蘐	カヤ	カンゾウ	ケン
蘑	ヒラタケ	マ
蘒	キ	ハ
蘓	ス	ソ	ヨミガエ
蘖	ゲツ	ヒコバエ
蘗	キハダ	キワダ	ハク/バク	ビャク
蘘	ショウ	ソウ	ニョウ	ノウ	ミヨウガ
蘙	エイ	シゲ
蘚	コケ/ゴケ	セン
蘛	イク	シゲ	ユ
蘞	ケン	コン	ヤブカラシ	レン
蘡	エイ	オウ	ヨウ
蘢	ロウ
蘧	キョ	ク
蘩	シロヨモギ	ハン	ボン
蘭	アララギ	カ	ラ	ラン
蘯	アラ	ウゴ	トウ	トロ
蘰	カツラ
蘶	ギ	ヒコバエ
蘸	サン	ヒタ
蘺	クサビエ	リ
蘼	ビ	ミ
蘽	カズラ	フジカズラ	ラ	リュウ	ルイ
蘿	ツタ	ラ
虀	ア	サイ	セイ
虁	キ
虂	ル	ロ
虆	カズラ	フジカズラ	ラ	リュウ	ルイ
虍	コ	トラカンムリ	トラガシラ
虎	コ	タケ	トラ
虐	イジ	ギャク	シイタ
虒	ケモノ	シ	ダイ	チ	テイ
虓	イカ	ウソブ	オウ	キョウ	コウ	シシ	タタ	ヨウ
虔	ケン	ツツシ
處	オ	コ	ショ	トコロ
虖	キョウ	ク	ケイ	コ	ホ
虗	ウツ	キョ	コ	ムナ
虘	サ	ソ	タケダケ
虙	フク
虚	ウツ	ウロ	キョ	コ	ムナ
虜	トリク	トリコ	リョ	ロ
虝	コ	トラ
虞	アザム	アヤマ	ウレ	オソレ	オモンパカ	グ	スケ	タノ	ノゾ	ハカ	モチ	ヤス
號	コウ	サケ	ヨビナ
虠	コウ
虡	キョ	ゴ	ハシ
虢	カク	ツメアト	ホウ
虣	シイタゲル	ホウ
虤	ガン	ケン
虧	カ	キ
虩	オソ	キャク	ケキ	サク	シャク
虫	キ	チュウ	ム	ムシ
虬	キュウ	キョウ	ク	ミズチ
虯	キュウ	キョウ	ク	ミズチ
虱	シツ	シラミ/ジラミ
虵	イ	ジャ	ダ	ヘビ	ヤ
虶	ウ
虷	カン	ボウフラ
虹	コウ	ニジ
虺	カイ	キ	ケ	マムシ
虻	アブ	ボウ
蚈	ケン	ホタル	ヤスデ
蚊	カ/ガ	ブン
蚋	カ	ゼイ	ゼツ	ネイ	ネチ	ブト	ブユ	ブヨ
蚌	ドブガ	ハマグリ	ビョウ	ホウ/ボウ
蚍	オオアリ	ヒ
蚑	キ	ゲ	ハウ
蚓	イン	ズ	ミミズ
蚕	カイコ	コ/ゴ	サン	テン
蚖	イモリ	ガン	ゲン
蚘	カイ	カイチュウ	ハラノムシ	ユウ
蚚	カイ	キ	ゲ	コクゾウムシ
蚜	アブラムシ	カ	ケ
蚡	フン	モグラモチ
蚣	コウ	ショウ
蚤	ソウ	ノミ	ハヤイ
蚦	ザン	ゼン	テン	ナン	ニシキヘビ	ネン
蚧	カイ
蚨	フ
蚩	シ
蚪	ト
蚫	アワビ	ホウ
蚭	ジ	ニ
蚯	キュウ	ミミズ
蚰	ユウ
蚱	サ	サク	シャ	シャク
蚳	シ	タイ	チ	テイ
蚴	ユ	ユウ
蚵	カ
蚶	カン
蚷	キョ	ゴ
蚸	シャク	セキ	リャク	レキ
蚹	フ	ホク
蚿	ケン
蛀	キクイムシ	シュ
蛁	チョウ
蛃	ヒョウ	ヘイ	ホウ
蛄	コ
蛅	セン	ネン
蛆	ウジ	ショ	ソ
蛇	アブ	イ	クチナワ	ジャ	ダ	ヘビ	ミ	ヤ
蛉	レイ
蛋	タン
蛍	ケイ	ホタル/ボタル
蛎	カキ	レイ
蛑	ボウ	ム	モウ
蛒	カク	キャク	スクモムシ	ラク
蛔	カイ	カイチュウ	ハラノムシ	ユウ
蛕	カイ	カイチュウ
蛗	フウ	ブ
蛙	ア	カエル/ガエル	カワズ	ワ
蛚	レチ	レツ
蛛	シュ	チュ
蛜	イ
蛞	カツ
蛟	キョウ	コウ	ミズチ
蛠	ライ	レイ
蛣	キチ	キツ	ケイ	ケチ	ケツ
蛤	コウ	ハマグリ
蛥	セツ	ゼチ	ニイニイゼミ
蛧	ボウ	モウ
蛩	キョウ	コオロギ
蛬	キョウ	キリギリス	コロギ
蛭	エビ	シツ	チツ	ヒル/ビル
蛮	エビス	バン
蛯	ウバ	エビ
蛸	ショウ	ソウ	タコ/ダコ
蛹	サナギ	ヨウ
蛺	キョウ	コウ	チョウ	リョウ
蛻	セイ/ゼイ	タイ	ヌケガラ	モヌ	モヌケ
蛼	アシマツイ	コオロギ	シャ
蛽	カイ	バイ
蛾	ガ	ギ	ヒムシ
蜀	イモムシ	ショク/ショッ	ゾク
蜂	ハチ/バチ	ホ	ホウ
蜃	シン
蜄	ウゴ	シン
蜅	フ	ホ
蜆	ケン	シジミ
蜇	サ	テチ	テツ
蜈	ゴ
蜉	フ
蜊	アサリ	リ
蜋	リョウ	ロウ
蜍	ショ
蜎	エン	ケン	ボウフラ
蜏	カゲロウ	シュ	シュウ	ユ	ユウ
蜐	キョウ	コウ
蜑	アマ	タン
蜒	エン	タン
蜓	エン	ジョウ	テイ	テン
蜔	テン
蜘	クモ	チ
蜙	シュ	ショウ	ス	ソウ
蜚	アブラムシ	ヒ
蜜	ビツ	ミツ
蜞	キ	ヒル
蜟	イク
蜡	ウジムシ	シャク	ショ	ジャ	セキ	ワ
蜣	カク	キャク	キョウ	コウ
蜥	シャク	セキ	トカゲ
蜨	ショウ	ソウ
蜩	カナカナ	セミ	チョウ	ヒグラシ
蜮	イキ	イサゴムシ	コク	ヨク	ワク
蜯	ドブガ	ハマグリ	ビョウ	ホウ
蜱	ダニ	ヒ	ヒョウ
蜲	イ	ウ
蜴	エキ
蜷	ケン	ニナ
蜹	カ	ゼイ	ゼツ	ネイ	ネチ	ブト	ブユ	ブヨ
蜺	ゲイ	ゲチ	ゲツ	ツクツクボウシ
蜻	セイ
蜼	イ	サル	ユイ	ルイ
蜽	コダマ	リョウ
蜾	カ	ジガバチ	ラ
蜿	エン	ワン
蝀	ツ	トウ
蝃	セチ	セツ	タイ	テイ	ニジ
蝅	カイコ	コ	サン	テン
蝉	セミ/ゼミ	セン/ゼン
蝋	アジ	ミツロウ	ロウ	ロウソク
蝌	カ
蝍	ショク	ソク
蝎	カツ	サソリ	スクモムシ
蝓	ユ
蝕	ショク	ムシバ
蝗	イナゴ	コウ	バッタ
蝘	エン	オン
蝙	コウモリ	ヘン
蝝	イナゴ	エン	ケン
蝟	イ	ハリネズミ
蝠	フク
蝡	ウゴメ	ジュ	ゼン	ダ	ニュ	ネン
蝣	ユウ
蝤	キクイムシ	シュウ	ジュ	ヨ	ヨウ
蝥	ブ	ボウ	ム	メウ
蝦	エビ	エミ	カ/ガ	ゲ
蝨	シツ	シラミ/ジラミ
蝪	エキ
蝮	フク	マムシ
蝯	エン	オン	テナガザル
蝱	アブ	ブウ	ボウ	ミョウ	モウ
蝲	サソリ	ラチ	ラツ
蝴	コ
蝶	チョウ
蝸	カ	カタツムリ
蝻	ナン
蝿	ハイ	ハエ/バエ	ヨウ
螂	ロウ
螃	ヒョウ	ホウ
螄	シ	ニナ
螅	シ	シツ
螆	シ
螇	ケイ
螈	イモリ	ガン	ゲン
螉	オ	オウ
螋	シュウ
螌	ハン
融	アキラ	ト/ド	トオル	ユウ
螐	ウ	オ
螓	シン	ナツゼミ
螕	オオアリ	ダニ	ヒ	ヘイ
螗	トウ	ナツゼミ
螘	アリ	ギ
螙	キクイムシ	ト
螞	バ	メ
螟	ズイムシ	ミョウ	メイ
螠	イ	ユムシ
螢	ケイ	ホタル
螣	ジン	チン	トウ
螧	エビ	ケン
螫	カク	サ	セキ
螬	シュウ	ジュ	ソウ
螭	チ	ミズチ
螮	タイ	テイ
螯	ゴウ	ハサミ
螱	イ	シロアリ
螳	トウ
螵	ヒョウ
螺	ニシ	ニナ	ラ
螻	ケラ	ル	ロウ
螽	イナゴ	シュウ
螾	イン	ミミズ
螿	ショウ	ソウ
蟀	シュツ
蟁	カ	ブン
蟄	カク	チツ/チッ	チュウ
蟆	バ	ヒキ	マ
蟇	ガマ	バ	ヒキ	ヒキガエル	マ
蟈	イキ	イサゴムシ	カク	ヨク
蟉	キュウ	リュウ	ル
蟊	ネキリムシ	ボウ	ム
蟋	シツ
蟎	ダニ
蟐	ジョウ	モミ
蟒	ウワバミ	オロチ	ボウ	モウ
蟕	シ	スイ
蟖	ケムシ	シ
蟙	コウモリ	シキ	ショク
蟚	ビョウ	ホウ
蟜	キョウ
蟟	クマゼミ	リョウ
蟠	ハン/バン	ワダカマ	ワラジムシ
蟢	キ
蟣	キ	ケ	シラミ
蟤	セン
蟪	エ	ケイ	ツクツクボウシ
蟫	イン	シミ	タン	ドン
蟭	シュ	シュウ	ショウ
蟯	ギョウ	ジョウ
蟱	クモ	ブ	ボウ	ム
蟲	キ	チュウ	ムシ
蟳	ガザミ	ジン
蟶	テイ	マテ
蟷	トウ
蟸	ニナ	ヒサゴ	ラ	ライ	リ	レイ
蟹	カイ	カニ/ガニ
蟺	セン	タン	ミミズ
蟻	アリ	ギ
蟾	セン
蟿	キ	ケイ
蠁	キョウ	ドウ	ニシドチ
蠃	カ	カタツムリ	ラ
蠅	ハイ	ハエ	ヨウ
蠆	タイ	タチ	タツ
蠉	ケン	ハウ
蠊	レン
蠋	ケムシ	ショク	ゾク	チョク	ドク
蠍	カツ	サソリ
蠎	ウワバミ	オロチ	ボウ	モウ
蠏	カイ	カニ
蠐	ザイ	シ	セイ
蠑	エイ
蠒	キヌ	ケン	マユ
蠓	カツオムシ	ボウ	ム
蠔	カキ	コウ
蠕	ウゴメ	ジュ	ゼン	ダ	ニュ	ネン
蠖	カク	ワク
蠘	セツ	ゼチ
蠙	ドブガイ	ヒン	ヘン
蠚	イタ	カク	サ	サスムシ	シャク	セキ	チャク
蠛	カツオムシ	ベツ	メチ
蠜	イナゴ	ハン	ボン
蠞	セツ	ゼチ
蠟	ミツロウ	ロウ	ロウソク
蠡	ニナ	ヒサゴ	ラ	ライ	リ	レイ
蠢	ウゴ	ウゴメ	シュン
蠣	カキ	レイ
蠧	キクイムシ	ト
蠨	アシタカグモ	ショウ
蠭	ハチ	ホウ
蠮	エチ	エツ
蠰	カミキリムシ	ショウ/ジョウ	ソウ	ニョウ
蠱	コ	マジ	マジコ	ヤ
蠲	ケ	ケイ	ケン	ヤスデ
蠵	イ	エ	キ	ケイ
蠶	カイコ	コ	サン	テン
蠹	キクイムシ	ト
蠺	カイコ	コ	サン	テン
蠻	エビス	バン
蠼	オオザル	カク	キャク	ク	ケキ	ワク
血	ケツ/ケッ	チ/ヂ
衁	コウ	チ
衂	ジク	ハナヂ
衃	ハイ	フ	フウ
衄	ジク	ハナヂ
衅	キン	スキ	チヌ	ヒマ
衆	オオ	シュ/ジュ	シュウ
衈	ジ	ニ
衉	カク	キャク
衊	バツ	ベツ	マチ	メチ
衋	イタ	キョク	コク
行	アルキ	アン	イ	イキ	イク	オコ	オコナ	ギョウ	クダリ	コウ/ゴウ	ナミ	ナメ	ミチ	ユ	ユキ	ユク
衍	アマリ	エン	シク	ハビコ
衎	カン	ヨロコ
衑	ミチ	リョウ	レイ
衒	ケン/ゲン	テラ
術	ジュツ/ジュッ	スベ
衕	ズ	トウ
衖	コウ	チマタ
街	カイ/ガイ	マタ	マチ
衘	カン	クツワ
衙	ガ	ギョ	ゴ
衚	コ
衛	イ	エ	エイ	マモル	モリ
衜	トウ	ミチ
衝	ショウ	ツ/ツキ/ツク/ヅ
衞	エ	エイ	マモ	マモリ	マモル
衟	トウ	ミチ
衠	シュン	タダ	マコト	モッパラ
衡	コウ	ショウ	ヒラ
衢	ク	ミチ
衣	イ	エ	キヌ	ギ	ギヌ	コロモ/ゴロモ
衤	コロモ	コロモヘン
表	アラ	アラワ	オモテ	ヒョウ/ビョウ/ピョウ
衩	サ	サイ	シャ
衫	サン
衰	オトロ	スイ
衱	キュウ	キョウ	コウ	ツクロウ
衲	コロモ	ドウ	ノウ
衵	アコメ	ジツ
衷	チュウ
衹	キ	シ	タイ	タマタマ	テイ
衻	セン	デン	ネン	フチド	マエダレ
衽	オクミ	コクビ	シトネ	ジン	ニン
衾	キン	フスマ/ブスマ
衿	エリ	キン	コン
袀	イクサゴロモ	キン	ビン
袁	エン	オン
袂	ケツ	タマト	タモト	ベイ
袈	カ	ケ/ゲ
袋	タイ/ダイ	テイ	ナイ	フクロ/フグロ/ブクロ	ブク
袍	ホウ	ワタイレ
袒	カタヌ	タン
袖	シュウ	ソデ
袗	シン
袘	イ	タ	ミゴロ
袙	アコメ	ハ	バツ
袚	ハチ	ハツ	ヒ	フク
袛	シ	タイ	テイ
袜	タビ	バツ	マチ
袞	コン
袟	サヤ	ジチ	チツ
袠	ジチ	チツ
袢	ハン/バン
袤	ナガサ	ボウ
袨	ケン	ハレギ
袪	キョ	コ	ソデ
被	オオ	カヅ	カブ	カブリ	ギヌ	コウム	ヒ/ピ
袮	チ	デイ	ネ
袰	ホロ
袱	フク
袴	ク	コ	ズボン	ハカマ/バカマ
袵	オクミ	コクビ	シトネ	ジン	ニン
袷	アワセ	キョウ	コウ
袺	カツ	ケチ	ケツ	ツマドル
袽	ジョ	ニョ	ヤブレゴロモ
袾	シュ	チュ	ミゴロ
袿	ウチカケ	ウチキ	ウチギ	ケイ
裀	イン	ミゴロ
裁	サイ	サバ	タ/タチ	タチ/ダチ
裂	ギ	サ/ザ	レツ/レッ
裃	カミシモ
裄	ユキ
装	ショウ	ソウ	ヨソ	ヨソオ
裊	シナヤ	ジョウ	チョウ	ニョウ
裋	シタギ	シュ	タン
裌	アワセ	キョウ	コウ
裍	コン	ナル
裎	ジョウ	チョウ	テイ	ハダカ
裏	ウラ	リ
裑	シン	ミゴロ
裒	ホ	ホウ
裓	イシダタミ	カイ	カツ	ケチ	コク	スソ
裔	エイ	スソ
裕	スケ	ノリ	ヒロ	ヒロシ	ヤス	ユ	ユウ	ユタカ
裘	カワゴロモ	キュウ	グ	ケゴロモ
裙	クン	モスソ
裛	オウ	フクロ	ユウ	ヨウ
補	オギナ	ホ/ポ
裝	ショウ	ソウ	ヨソオ
裞	エイ	セイ	タイ
裟	サ	シャ
裡	ウチ	ウラ	リ
裧	セン	タレギヌ	タン
裨	オギナ	タス	ヒ	マス
裯	ジュ	チュウ	トウ	ハダギ
裰	タチ	タツ	ツクロウ
裱	ヒョウ	ヒレ
裲	ウチカケ	リョウ
裳	ショウ	モ	モスソ
裴	タチモトオ	ハイ	ヒ	ベ
裵	タチモトオ	ハイ	ヒ	ベ
裷	エン	オン	ケン	コン	ズキン
裸	ハダカ	パダカ	ラ
裹	カ	ツツ	ホウ
裼	セキ	テイ	ハダヌ
製	セイ
裾	キョ	コ	スソ
褁	シャク	セキ	フクロ
褂	ウチカケ	ウチキ	カイ	ケ	ケイ
褄	ツマ/ヅマ
褆	シ	ダイ	テイ
複	フク/フッ/プク
褊	セマ	ヘン
褌	コン	フンドシ
褍	タ	タン	トン	ミゴロ
褎	シュウ	ジュ	ソデ	タモト	ユ	ユウ
褏	シュウ	ジュ	ソデ	タモト	ユ	ユウ
褐	カツ/カッ
褒	ホ/ボ	ホウ
褓	ホ	ホウ	ムツキ
褕	ズ	トウ	ハネカザリ	ユ	ヨウ
褖	コロモ	タン
褘	イ	キ	キク	ヒザカケ
褙	ハイ	ハダギ
褚	シャ	チョ	ワタイレ
褜	エナ	ホウ
褝	ゼン	タン	ヒトエ
褞	ウン	オン	ヌノコ
褠	アワセ	ク	コウ	ヒトエ	ヒトエノツツソデウデヌキ
褥	シトネ	ジョク
褦	ダイ	ナイ	ヒガサ
褧	キョウ	ケイ	ヒトエ
褨	サ	ジャ
褪	ア	サ/ザ	タイ	トン	ヌ
褫	ウバ	チ
褰	ケン	コン	ハカマ
褱	イダ	エ	オモ	カイ	ナツ	フトコロ
褲	コ	ズボン
褵	オビ	キンチヤク	リ
褶	カサネ	シュウ	ショウ	チョウ
褸	イト	ル	ロ	ロウ
褹	ゲイ	ナイ	ナチ	ヌノコ	ネ
褺	カサネゴロモ	ジョウ	チョウ
褻	ケ	ケガ	セツ	ナ
褾	ソデクチ	ヒョウ
襀	シャク	セキ	ヒダ
襁	キョウ	ムツキ
襂	サン	シン	セン	ヒトエ
襃	ホ	ホウ
襄	ショウ/ジョウ	ノボル	ハラ
襅	チハヤ
襆	ホク/ボク	モスソ
襉	カン	ケン	スソノヒダ
襌	ゼン	タン	ヒトエ
襍	ザツ	ゾウ	マジ
襏	アラヌノ	ハチ	ハツ	フチ	フツ
襒	コロモ	ヘツ	ベチ
襖	アオ	オウ	フスマ
襗	エキ	シタバカマ	ジャク	タク	ヤク
襚	スイ
襛	アツ	ジュウ	ジョウ	ニュ
襜	セン	タン	マエカ
襞	シワ	ヒダ	ヒャク	ヘキ
襟	エリ	キン
襠	トウ	フンドシ	マチ
襡	シュ/ジュ	ショク	ゾク	タク	ナガジュバン
襢	セン	タン	チン	ハダヌギ
襣	ヒ	フンドシ
襤	ボロ	ラン
襦	シタギ	ジュ	ハダギ
襪	バツ	ベツ
襫	シャク	セキ
襭	ケツ	ツマバサ	ハサ
襮	エリ	ハク	ホク
襯	シン	ハダギ
襰	オ	ヤブ	ライ
襲	オソ	オソイ	カサ	カサネ	シュウ	ソイ
襳	サン	シタギ	シン	セン
襴	ラン	リン
襵	ショウ	タタ	チョウ	ヌ	ヌイメ	ヒダ	マ
襷	タスキ/ダスキ
襺	ケン	ワタイレ
襻	ツケヒモ	ハン
襼	ゲイ	ソデ
襽	ラン	リン
襾	ア	ケ	ニシ
西	イリ	サイ/ザイ	ス	セイ/ゼイ	ニシ	ヒシ	ムラ
要	イ	カナメ	トシ	ヨウ
覃	エン	タン
覆	オオ/オオイ	クツガエ	フク/フッ/プク
覇	ハ/パ	ハク	ハタガシラ	ハル
覈	カク	ケツ	シラ
覉	オモガ	キ	タヅナ	タビ	ツナ	ハ
覊	オモガ	キ	タヅナ	タビ	ツナ	ハ
見	ケン/ゲン	マミ	ミ/ミア/ミウ/ミエ/ミオ/ミソ/ミナ/ミノ/ミマ/ミル
覍	ヘン
規	キ/ギ	スノリ	タダシ	ノリ	ミ
覐	オボ	カク	サ	サト
覓	エキ	ベキ	ミャク	モト
覔	エキ	ベキ	ミャク	モト
覕	ヒン	ヘツ	メチ
視	シ	トモ	ミ
覗	ウカガ	シ	ノゾ/ノゾキ
覘	ウカガ	テン	ノゾ/ノゾキ
覚	オボ/オボエ	カク/ガク	サ/サマ/ザ	サト	サトシ	サトル	ザマ
覛	バク	ビキ	ベキ	ミ	ミャク
覜	チョウ	ミ
覟	シ	ミ
覠	キン	コン	ミ
覡	カンナギ	ケキ/ゲキ	ミコ
覥	テン	ハジ
覦	ネガ	ユ
覧	ミ	ラン
覩	ト	ミ
親	オヤ	ギ	シタ	シン	チカ	チカシ	ノリ
覬	キ
覯	ア	コウ
覰	アラ	ウカガ	キョ	シュ	ショ	ス	ソ	ミ
覲	キン	マミ
観	カン/ガン	シメ	ミ
覴	チョウ	トウ	ミ
覵	ウカガ	エン	カン	ケン	ヘン	マゼル	ミル
覶	ミ	ラ	ラン	レン
覷	アラ	ウカガ	キョ	シュ	ショ	ス	ソ	ミ
覺	オボ	カク/ガク	サ	サト	サトル
覼	ミ	ラ	ラン	レン
覽	ミ	ラン
覿	ア	テキ
觀	カン	シメ	ミ
角	イ	カク/カッ/ガク	カト	カド	ス	スミ/ズミ	ツノ/ヅノ	フサ
觔	キン	スジ
觕	アラ	ジョウ	ソ	ソウ
觖	カ	キ	ケイ	ケチ	ケツ
觗	サカズキ	シ
觘	ショウ	ソウ	ツノサジ
觚	コ	サカズキ
觜	クチバシ	シ	スイ	ハシ
觝	テイ	フ
解	カイ	ゲ	サト	サトル	ト/トキ/ド	トケ	ホグ	ホツ	ホド/ホドキ	ワ	ワカ
觥	コウ	ツノサカズキ
触	サワ/ザワ	ショク/ショッ	フ/フレ/ブ	フレ/ブレ
觧	カイ	ゲ	サト	ト	ホド	ワカ
觩	キュウ	ク	マ
觫	ソク
觭	カタム	キ
觱	ウチ	ウツ	ヒチ	ヒチリキ	ヒツ
觳	カク	コク
觴	サカズキ	ショウ
觶	サカズキ	シ
觸	サワ	ショク	フ
觹	エ	キ	クジリ	ケイ	スイ	ツノギリ
觽	エ	キ	クジリ	ケイ	スイ	ツノギリ
觿	エ	キ	クジリ	ケイ	スイ	ツノギリ
言	イ	イイ	ゲン	コト/ゴト	ゴコロ	ゴン	トキ	ユ
訂	テイ
訃	シラセ	ツ	フ
訄	キュウ	ク	コウ	ドウ	ノウ
訅	キュウ	ク	ハカ	ヤス
訇	キン	ケン	コウ
計	エ	カズ	ケ/ゲ	ケイ	ハカ/ハカラ/ハカリ/バカ	ハカリ/バカリ	ハカル
訊	キ	シュン	シン/ジン	タズ	ト
訌	コウ
討	ウ/ウチ	トウ
訏	イツワ	ク	コ
訐	アバ	ケツ
訑	イ	シ	タ	タン
訒	ジン	ナヤ	ニン
訓	オシ	キン	ク	クニ	クノ	クン	サトシ	ノリ	フミ	ヨ
訔	カタ	ギン	ゴン
訕	サン	セン	ソシ
訖	オ	キツ/キッ	ツイニ
託	カコ	カコツ	コトヅ	タク
記	キ/ギ	シル	ノリ
訛	アヤマ	カ/ガ	ナマ/ナマリ
訝	イブカ	ガ	ゲ
訞	アヤシイコトバ	ヨウ	ワザワ
訟	ショウ
訠	イワ	シン	ハ	ハギ
訢	キ	キン	コン	ヨシ	ヨロコ
訣	ケツ/ケッ	ワカ	ワカレ
訤	コウ	コン	ダ
訥	トツ	ドモ
訦	シン	マコト
訪	オトズ	オトナ	タズ	ト	ホウ/ボウ	ワ
訫	シン	マコト
訬	ショウ	ソウ	ミダ	ミョウ
設	シタ	シツラ	セツ/セッ	モウ
訯	サ	シャベ	セ
許	キョ	バカ	モト	ユル
訳	ヤク	ワケ
訴	ウッタ	ソ
訵	チ	ヒソカニ	ヒソカニウカガイ
訶	カ	シカ	セ
訷	シン	トク
診	シン	ミ
註	チュウ
証	アカ	アカシ	ショウ
訽	ク	コウ	ノノシ	ハジ	ハズカシ
訾	サイ	シ	セイ	ソ	ソシ	ツトメナイ
詀	セン	タン	テン
詁	コ	ヨミ
詃	イザナ	イツワ	ケン
詅	テラ	リョウ	レイ
詆	シカ	ソシ	タイ	テイ
詇	エイ	オウウ	コエ	サトイ	ツ	トウ	ヨウ
詈	ノノシ	リ
詉	カマビス	ダ	ド	ドウ	ナ	ヌ	ヒョウ	ワルクイ
詍	エイ	シャベ	セチ	セツ	タノ
詎	キョ	ゴ	ナンゾ
詐	イツワ	サ
詑	アザム	イ	タ/ダ	ワ
詒	アザム	イ	タイ
詓	キョ	コ	コエ
詔	サトシ	ショウ	ノリ	ミコトノリ
評	ヒョウ/ピョウ
詖	カタヨ	ハ	ヒ
詗	キョウ	ケイ	サグ	チョウ
詘	クチ	クツ	チュチ	チュツ	ツ	トツ
詛	ショ	ソ	ノロ	ノロイ
詜	トウ	ミダ
詝	サトイ	チョ
詞	コトバ	シ/ジ
詠	ウタ	エ	エイ	エエ	ヨ/ヨミ
詡	ク	ホコ
詢	シュン/ジュン	ハカ	マコト
詣	イタ	ケイ/ゲイ	マイ	モウ	モウデ
詥	アツマリイウ	カナ	コウ	ヤワラ
試	ココロ	シ/ジ	タメ/ダメ
詧	アキラカ	サチ	サツ	セチ	セツ	ミル
詩	ウタ	シ
詫	カコツ	タ	タク/ダク	ワ	ワビ
詬	ク	コウ	ノノシ	ハジ	ハズカシ
詭	イツワ	キ
詮	アキ	カイ	セン
詰	キチ	キツ/キッ	ズメ	ツ/ツマ/ツミ/ツメ/ヅ	ヅマ	ヅメ	ナジ
話	ハナ	ハナシ/バナシ	ワ
該	ガイ
詳	クワ	ショウ	ツマビ	ヨシ
詵	シン	セン	ト
詶	シュウ	ジュ	ノロ
詷	オナジ	ズ	トウ
詹	セン	タン
詺	ナヅ	ビイ	ベイ	ミョウ
詻	イイアラソ	ガク	ギャク	ラク	リャク
詼	カイ	タワムレ
詾	イイタテ	ウッタ	オド	キョウ	ク	ミ
詿	アヤマ	カ	カイ	ケ
誀	サソウ	ジ	チ	ニ	ハジ
誂	アツラ	アツラエ	イド	チョウ
誃	イ	シ	チ	ワカ
誄	シノビゴト	ルイ
誅	コロ	セ	チュ	チュウ
誆	イツワリ	キョウ	ゴウ
誇	コ	ホコ
誉	エ	タカ	タケ	ホ	ホマ	ホマレ	ホメ	ホン	ヨ
誋	イマシ	キ	コウ
誌	シ
認	シタタ	ニン	ミト/ミトメ
誏	ロウ
誐	ガ	クチズサム	ヨイ	ヨイコトバ
誑	キョウ	タ	タバカ	タブラ	タブラカ	タラ
誒	ア	アイ	イ	カイ	キ
誓	セイ/ゼイ	チカ	チカイ
誕	タン
誖	フチ	フツ	ホツ	ボチ	ミダ
誗	コトバガウルワシイ	テン
誘	イザナ	オビ	サソ	ユウ
誙	アラ	ギョウ	ケイ	コウ
誚	ショウ	セ
語	カタ/ガタ	カタリ	ガタリ	ゴ
誟	コウ
誠	キヨ	サト	シゲ	セイ	トモ	ノブ	マ	マコ	マコト	マサ
誡	イマシ	カイ
誣	アザム	シ	シイ	フ/ブ
誤	アヤマ	ゴ
誥	コウ	ツ
誦	ショウ	ジュ	ズ	トナ	ヨ
誧	フ	ホ
誨	オシ	カイ
誩	アラソイイウ	キョウ	ケイ	ゴウ	タン	トン
説	サトシ	セツ/セッ/ゼツ	ゼイ	ト/ド	トキ
読	トウ	トク/ドク	ド	ドク/ドッ	ヨ	ヨミ
誮	カ	ヤサ
誯	ショウ	トナ
誰	スイ	タ	タレ/ダレ
課	カ
誳	クツ	コチ	ツ	マ
誶	サイ	シュツ	スイ	セ	ノノシ
誷	シイ	ボウ	モウ
誹	ソシ	ハイ	ヒ
誻	ソシ	トウ
誼	ギ	ヨイ	ヨシ	ヨシミ
誾	ギン	ゴン
調	ギ	シラ/シラベ	チョウ/ヂョウ	ツギ	トトノ
諂	テン	ヘツラ
諃	チン	ヨクイウ
諄	クド	クドクド	シュン/ジュン	ネンゴ	ヒチクド
諆	アザム	キ
談	ダン
諈	カコツ	スイ	チ	ニ
諉	イ	ズイ	ニ	ワズラ
諊	キク	コク	シラベ
請	ウ	ウケ	コ/ゴ	ショウ	シン	セイ
諌	イサ	カン
諍	アラソ	イサ	イサカ	イサカイ	ウッタ	ショウ/ジョウ	ソウ
諏	シュ	ス/ズ	ソウ	ハカ
諑	ウッタエ	タク
諒	アキ	アキラ	マコト	マコトニ	マサ	リョウ
諓	エン	セン	ヨクイウ
諔	イツワ	シュク	ジャク	セキ
諕	カ	コウ	サケ	テ
論	アゲツラ	ロン
諗	イサ	シン	ジョウ	ニョウ
諚	ジョウ
諛	ヘツラ	ユ
諜	ウカガ	シメ	チョウ
諝	サトイ	ショ
諞	ヘン
諟	シ	タイ	タダ	テイ
諠	カマビス	ケン	ミツグ	ワス
諡	エキ	オクリナ	シ
諢	コン
諤	アゴ	ガク	ワメ
諦	アキラ	タイ	ツマビラカ	テイ	マコト
諧	カイ	カナ	ヤワ
諫	イサ	カン
諬	ケイ	サト	ヒラ
諭	サト	サトシ	サトル	ユ	ユウ
諮	シ	ハカ
諰	アイ	オモ	サイ	シ	シャ
諱	イ	イミナ	キ
諳	アン	オン	ソラ	ソラン
諴	カン	ゲン	コン	ヤワ
諵	ダン	ナン	ネン
諶	シン	マコト
諷	ソラ	フウ
諸	ショ	モロ
諺	ゲン	コトワザ
諼	イツワ	カマビス	ケン	ワス
諾	ウベナ	ダク
諿	シュウ	ショ	ヤワ
謀	タバカ	ハカ	ハカリゴト	ボウ	ム
謁	エツ/エッ
謂	イ	イイ	イワ	イワユル	イワレ	オモ	ユ
謄	トウ
謅	シュ	シュウ	ショウ	ソウ	モテアソ
謆	セン	マド
謇	ケン	ドモ
謊	イツワ	コウ
謋	カク	キャク	ケキ	ケツ	トク
謌	ウタ	カ
謎	ナゾ	ベイ	メイ
謐	シズカ	ヒツ
謑	カ	ケ	ケイ	ハジ
謔	キャク/ギャク	タワム
謖	シュク	ショク	タ
謗	ソシ	ホウ/ボウ
謙	カネ	ケン	ヘリクダ	ユズル
謚	エキ	オクリナ	シ
講	コウ
謜	ガン	ゲン	セン
謝	アヤマ	サ/ザ	シャ/ジャ
謞	カク	キョウ	コウ
謟	ウタガ	トウ
謠	ウタ	ヨウ
謡	ウタ	ウタイ	ヨウ
謦	ケイ	シワブキ
謨	ハカ	ボ	モ
謫	セ	タク/タッ	チャク	トガ
謬	アヤマ	ビュウ	ビョウ	ミュウ
謭	アサ	セイ	セン
謰	オシャベリ	レン
謳	ウ	ウタ	オウ
謷	ギュウ	ギョウ	ク	ゴウ	ヤカマ
謹	キン	ツツ	ツツシ
謼	キョウ	ク	コ	コウ	ヨ
謾	アザム	アナド	バン	マン
譁	カ	カマビス	ケ
譂	イツワ	セン
譃	イツワ	ウソ	ク
譄	シイ	ソウ
譅	シュウ	ドウ	ノウ
譆	アア	イ	キ
譈	ウラ	ズイ	タイ
證	アカシ	ショウ
譌	アヤマ	カ	ナマ
譍	オウ	コタ	ヨウ
譎	イツワ	キツ	ケツ
譏	キ	ソシ
譒	シク	ハ
譓	エ	カシコ	ケイ
譔	オシ	セン
譖	シン	セン	ソシ
識	サト	サトル	シ	シキ	シル
譙	シカ	ショウ	スイ
譚	タン	ハナシ
譛	シン	セン	ソシ
譜	フ/プ
譞	オオクモノイウ	ケン	サカシイ	チエ
譟	サワ	ソウ
譣	ケン	セン	トウ
警	イマシ	ケイ
譫	ウルサクシャベ	ウワゴト	セン	タワゴト	タン	トウ
譬	タト	ヒ
譭	キ
譯	ヤク	ワケ
議	カタ	ギ	ノリ
譱	イ	ゼン	ヨ
譲	ジョウ	ユズ/ユズル	ユズリ
譴	ケン	セメ
譶	ジュ	チュウ	トウ	ハヤクチ
護	ゴ	マモ	マモル	モリ
譸	ジュ	チュ	チュウ	ノロ
譹	コウ	サケ	タブラ
譼	カン
譽	ホ	ホマ	ヨ
譾	アサ	セイ	セン
讀	トウ	トク/ドク	ヨ
讁	セ	タク	チャク	トガ
讃	サヌ	サン	タタ	ホ
讄	イ	イノル	ル
讅	シン	ツマビ
變	カ	ヘン
讋	オソ	ショウ	トウ
讌	ウタゲ	エン
讍	アゴ	ガク	ワメ
讎	アダ	カタキ	シュウ
讏	エ	エイ	ネゴト
讐	ア	アダ	シュウ	ムク
讒	サン/ザン	ソシ
讓	ジョウ	ユズ	ユズル
讔	イン	オン	ナゾ
讕	ソシ	ラン
讖	シン
讙	カマビス	カン	ケン
讚	サン	タタ	ホ
讜	タダシイコトバ	トウ
讞	ゲチ	ゲツ	ゲン	サバ
讟	ウラ	トウ	トク
谷	ガイ	ガエ	ガヤ	キワ	コク/ゴク	セ/ゼ	タニ	タリ	タン/ダン	ダニ	ヤ	ヤツ
谸	セン
谹	オウ	コウ	フカ
谺	カ	コ	コダマ
谽	カン	ケン	コン
谾	ウツロ	ク	コウ	ル	ロウ
谿	ケイ	タニ	タニガワ
豁	カツ/カッ	ヒラ	ヒロ
豅	ル	ロウ
豆	ズ	トウ/ドウ	ド	マ	マメ
豇	コウ	ササ
豈	アニ	カイ/ガイ	キ
豉	シ	ミソ
豊	テ/デ	ト	トヨ	ヒロシ	フウ	ブ	ブン	ホ	ホウ/ポウ	ミノル	ユタ	ユタカ
豋	タカツキ	トウ
豌	エン	ワン
豎	コドモ	ジュ	タ	タテ
豏	カン	ゲン	メバ
豐	トヨ	ブ	ホウ	ユタ
豑	ジュチ	チツ
豓	アデ	エン	ツヤ	ナマ	ヨシ
豔	アデ	エン	ツヤ	ナマ	ヨシ
豕	イノコ	シ
豗	ウ	カ
豘	トン	ブタ
豙	ギ	ソコ
豚	トン	ブタ
豛	イノコ	エキ	ヤク
豝	ハ	ヘ
象	カタド	キサ	ショウ	ゾウ
豢	カン	ケン	ヤシナ
豣	イノコ	ケン
豤	カ	ケン	コン
豦	キョ	ゴ	ヤメナイ
豨	キ	ケ
豩	カン	ケン	ヒン
豪	エラ	コウ/ゴウ	ゴ	スグル	タケ	タケシ	ツヨシ	ヒデ	マサル
豫	アラカジ	シャ	ヨ
豬	イ	イノシシ	チョ
豭	オスノイノコ	カ	ケ
豳	ハン	ヒン	ヘン
豵	イノコ	シュ	ショウ	ス	ソウ
豶	フン
豸	タイ	チ	ムジナヘン
豹	ヒョウ/ピョウ	ホウ
豺	サイ	ヤマイヌ
豻	カン
豼	ヒ
豾	コダヌキ	ヒ
貂	チョウ	テン
貅	キュウ
貆	カン	ケン	ムジナ
貇	カ	ケン	コン
貉	カク	ハク	ムジナ
貊	エビス	ハク	ミャク
貋	カン
貌	カタチ	カタドル	バク	ボウ
貍	タヌキ	ライ	リ
貎	ゲイ
貐	イ	ケモノ	ユ
貒	タン	マミ
貓	ネコ	ビョウ
貔	ヒ
貘	バク	ミャク
貙	ケモノ	チュ	チョ
貛	カン	ケン	マミダヌキ
貜	オオザル	カク	キャク	ク	ケキ	ワク
貝	カイ/ガイ	バイ
貞	サザ	サダ	タダシ	テイ	リョウ
負	オ	オイ	フ/ブ	マ	マケ
財	サイ/ザイ	ゾク	タカラ
貢	ク/グ	コウ	ミツ	ミツギ	ミツグ
貤	イ	カサ	シ
貧	ヒン/ビン/ピン	マズ
貨	カ	タカラ
販	ハン/パン
貪	タン	トン	ドン	ムサボ
貫	カン/ガン	ツラ/ヅラ	ツラヌ	ヌ	ヌキ	ヌク/ヌッ
責	セ/セメ/ゼ	セキ	セメ/ゼメ
貭	シチ	シツ	タダ	タチ	チ	モト	ワリフ
貮	ジ	ソエ	ニ	フタ
貯	タ/ダ	タクワ	チョ
貰	シャ	セイ	モラ	モライ
貲	シ	タカラ
貳	ジ	ソエ	ニ	フタ	フタツ
貴	キ/ギ	キヨ	タカ	タカシ	タット	トウト	ヨシ
貶	オト	オトシ	ケナ	サゲス	ヘン
買	カ/カイ/ガ	ガイ	バイ
貸	カ/ガ	カシ/ガシ	タイ
貹	ショウ	セイ	タカラ
貺	キョウ	コウ	タマ
費	ツイ	ツイヤ	ヒ/ピ
貼	チョウ	ツ	テン	ハ/ハリ/バ	ハリ/バリ
貽	イ	オク
貿	ボウ
賀	カ/ガ	ノリ	ヨシ	ヨリ
賁	ヒ	フン	ホン
賂	マイナ	マイナイ	ロ
賃	スケ	チン
賄	マカナ	マカナイ	ワイ
賅	カイ	タ
賆	ヒョウ	ヘイ	ヘン	マス
資	シ/ジ	スケ	モト
賈	アキナ	ウ	カ	コ
賉	ウレ	シュチ	シュツ	ソチ	ソツ
賊	ゾク
賋	アキラカ	コウ
賍	ソウ
賎	イヤ	シズ	シツ	セン/ゼン	ヤス
賏	エイ	オウ	クビカザリ	ヨウ
賑	シン	ニギ	ニギヤ	ニギワ	ニギワイ
賓	ヒン/ピン
賕	キュウ	ク	マイナイ
賖	オゴ	オゴリ	シャ	トオ	ハルカ	ユル
賙	アタ	シュ	シュウ
賚	タマ	タマモノ	ライ
賛	サン	タス	タタ
賜	シ	タ	タマ	タマモノ	タマワ	タモ
賝	タカラ	チン
賞	ショウ/ジョウ	ホ
賠	バイ
賡	キョウ	コウ	ショク	ゾク	ツグナ	ツヅ
賢	カシコ/ガシコ	カタ	ケン/ゲン	サカ/ザカ	サト	サトシ	タカ	タテ	ノリ	マコト	マサ	マサル
賣	ウ	バイ
賤	イヤ	シズ	シツ	セン/ゼン	ヤス
賦	ウタ	フ/ブ/プ
賨	ズ	ソウ	ミツ
質	シチ	シツ/シッ	タダ/タダシ	タチ	チ	モト	ワリフ
賬	チョウ	トバリ
賭	カ	カケ	ト
賯	ケイ	タカラ
賰	アツ	ウゴメ	シュン	チュン	ト
賲	コメグラ	タモツ	ホウ
賵	オク	フ	フウ	ボウ
賷	サイ	シ	セイ	モタ
賸	ショウ	マス	ヨウ
賺	スカ	タン	レン
賻	フ
購	アガナ	コウ
賽	サイ
賾	オクブカ	サク	ジャク
賿	ゼニ	リョウ	ロウ
贁	ハイ	ヤブ
贃	ス	ワン
贄	シ	ニエ
贅	イボ	セイ/ゼイ
贇	イン
贈	オク	ソウ/ゾウ
贉	タン	テツケ	ドン
贊	サン	タス	タタ
贋	ガン	ニセ
贍	スク	セン
贏	アマリ	エイ
贐	シン	ハナムケ
贒	カシコ	ケン
贓	ソウ/ゾウ
贔	ヒ	ヒイ/ビイ
贖	アガナ	ショク
贗	ガン	ケン/ゲン	タダ	ニセ	ニセモノ
贛	カン	ク	コウ	コン	タマ
赤	ア	アカ/アカガ/アカミ/アカム/アガ	アコ	アマ	カ	シャク/シャッ	セキ
赥	アカ	キャク	ケキ	コキ
赦	シャ	ユル
赧	アカラ	タン
赩	アカ	カク	キャク	キョク	コク
赫	アカ	アカイ	カガヤ	カク
赬	アカ	チョウ	テイ
赭	アカツチ	シャ
赮	アカ	カ	ゲ
走	ソウ	ハシ/バシ/パシ	ハシリ/バシリ
赱	ソウ	ハシ
赳	キュウ	タケ	タケシ
赴	オモム	フ
起	オ/オキア	オキ	オコ	オコシ	キ/ギ	タ
赿	チ	テイ
趁	オ	チン
趂	チン
趄	ショ
超	コ	ゴエ	ススム	チョウ	マサル	ワタル
趈	ケン	タン
越	エチ	エツ/エッ	オ	オツ/オッ	コ/コス/ゴ	コエ/ゴエ	コシ/ゴシ	ゴヤ
趍	シュ	ジ	ス	チ	ヒサ
趐	ケチ	ケツ	スス
趑	シ	ユキナヤ
趕	オ	カン
趙	キョウ	ジョウ	チョウ
趞	サク	シャク	セキ	フ
趟	オド	ジョウ	チョウ	トウ
趠	タク	チョウ	トオ
趣	オモム	オモムキ	シュ/ジュ
趦	シ	ユキナヤ
趨	オモム	シュ	スウ	ソク	ハシ
趫	キョウ	スバヤ	チョウ
趬	キョウ	ミガルイ
趯	カン	サケ	ヤク
趲	サン	ソ	チ
足	ア	アシ/アシガ	アス	オス	ソク/ソッ/ゾク	タ/タシ/タリ/タル/ダ	タラシ	タル/ダル
趵	ウ	サク	シャク	ハク	ヒョウ	ホウ
趷	ゲ	コツ
趹	ケ	ケイ	ケチ	ケツ	ハシ
趺	アシ	シ	フ
趻	シン	タン	チン	テン	フラフラ
趼	ケン	ツマダ
趾	アト	シ	ハヤ
跀	アシキル	イビツ	グワチ	ゲツ	ゴチ	ゴツ	ユガ
跂	キ	ツマダ	ムツユビ
跅	シャク	セキ	タク	ユル
跆	タイ	フ
跇	エイ	コ	セイ	テイ
跈	セン	デン	ネン	フ
跊	バイ	フ	マイ	メ
跋	オクガキ	ハツ/バツ	バツ/バッ	フ
跌	アヤマツ	ツマズ	テツ
跎	タ	ツマズ
跏	カ
跑	アガ	ダク	ハク	ビョウ	ホウ
跔	カガ	ク
跕	チョウ	フ
跖	アシノウラ	セキ
跗	アシノコウ	フ
跙	シャ	ショ	ソ	ユキナヤ
跚	サン
跛	チンバ	ハ	ヒ	ビッコ
距	キョ	ケヅメ	ヘダ
跟	クビ	コン
跡	アト	セキ/ゼキ
跣	セン	ハダシ
跤	キョウ	コウ	スネ
跥	タ	ユ
跧	ケ	シュン	セン	ソン
跨	カ	コ	マタ/マタギ	マタガ
跪	キ	ヒザマズ
跫	キョウ
跬	カイ	キ	ケ	ヒトアシ
路	ジ	ミチ	ル	ロ
跰	シタガ	ヘイ	ヘン	ホウ
跱	ジ	チ	トド
跲	キュウ	キョウ	コウ	ツマズ
跳	チョウ	ト/トビ	ハ/ハネ
跴	オ	サイ
践	セン	フ
跼	カガ	キョク	クグマ	コゴ	セグク	セグクマ
跽	キ	ヒザマズク
跿	ト
踁	ケイ	スネ	ハ
踄	ハク	フ/ブ	ホ
踅	ケンケン	セツ	ゼチ	テイ
踆	シュン	シリゾ	ソン
踈	ウト	ショ	ソ	マバ
踉	リョウ	ロウ
踊	オド	オドリ	ヨウ
踋	アシ	カク	キャ	キャク
踏	トウ	フ/フマ/フミ/ブ	フミ/ブミ
踐	セン	フ
踑	アシアト	キ
踔	タク	チョウ	トウ	フ
踖	サク	シャク	セキ	フ
踝	カ	クルブシ
踞	ウズク	ウズクマ	キョ	コ
踟	チ
踠	エン	オン	カガ	モガ	ワ
踡	カガ	ケン
踢	ケ	シャク	チャク	テキ
踣	タオ	ハイ	ホウ	ホク
踦	カタアシ	キ
踧	イキヤスイ	シュク	ジャク	テキ
踪	アト	ショウ	ソウ
踰	コ	ユ	ヨウ
踱	ジャク	タク	ハダシ
踳	シュン	セン	ソム
踴	オド	ヨウ
踵	カカト	キビ	キビス	クビ	クビス	ショウ	ツ
踶	ジ	ダイ	チ	テイ	フ
踷	タ	ナナメニユク
踸	シン	タン	チン	テン	フラフラ
踹	カカト	セン	タン
踽	ク
蹀	ジョウ	チョウ	フ
蹁	ヘン	ヨロメ
蹂	ジュウ	フ
蹄	テイ	ヒズメ	ヒヅメ
蹇	アシナエ	イザ	ケン	ナヤ
蹈	トウ	フ
蹉	サ	ツマズ
蹊	ケイ	ミチ	ワタ
蹋	トウ	フ
蹌	ウゴ	ショウ	ソウ	ヨロ
蹍	テン	ネン	フ
蹎	ツマズ	テン
蹏	テイ	ヒヅメ
蹐	セキ
蹔	サン	トッシン
蹕	サキバライ	ヒツ
蹙	シュク	セ	セキ
蹛	タ	タイ	テイ	フ
蹜	シュク	スク
蹝	シ	フ
蹞	キ	ヒトアシ
蹟	アト	シャク	セキ
蹠	アシウラ	アシノウラ	セキ
蹡	ショウ	ソウ	ヨウ
蹢	ジャク	タク	タタズ	テキ
蹣	ハン	マン	ヨロ
蹤	アト	ショウ
蹩	フ	ヘツ	ベチ
蹬	トウ	ヨロメ
蹭	ショウ	ソウ	ヨロメ
蹯	アシノウラ	ハン	フン	ボン
蹰	シュウ	ジュ	タメラ	チュ	チュウ
蹱	シュ	ショウ	タメラ	チュ	チョウ
蹲	ウズクマ	シュン	ソン	ツクバ/ツクバイ
蹴	ケ/ゲ	シュウ	シュク
蹶	ケ	ケイ	ケツ/ケッ	タオ	ツマズ
蹹	トウ	フ
蹺	キョウ	ミガルイ
蹻	ガク	キャク	キョウ
蹼	ホク/ボク	ミズカキ
躁	サワ	ソウ
躂	タチ	タツ	ツマズ
躃	イザ	ヘキ
躄	イザ	イザリ	ヘキ
躅	タク	チョク
躇	タメラ	チャク	チョ
躉	トン	ハシケ
躊	シュウ	ジュ	タメラ	チュ	チュウ
躋	サイ	セイ	ノボ
躍	オド	オドリ	ヤク/ヤッ
躐	フ	リョウ
躑	シャガ	タチモトオ	テキ
躒	ウゴ	ラク	リャク	レキ
躓	チ	ツマズ
躔	テン	フ
躕	シュウ	ジュ	タメラ	チュ	チュウ
躙	ニジ	フ	リン
躚	セン	マ
躛	エ	エイ	カイ	ケ	フ
躝	コ	タン	ラン
躞	ショウ	ユ
躡	ジョウ	フ
躢	トウ	フ
躧	クツ	サイ	シ	シャ	リ
躩	カク	キャク	ケキ	ススマナイ
躪	ニジ	フ	リン
身	シン/ジン	ミ
躬	キュウ	キョウ	ミ
躭	タン	フ
躮	サガレ	セガレ
躯	カラダ	ク	ムクロ
躰	カタチ	カラダ	タイ	テイ
躱	カ	カワ	タ
躳	キュウ	キョウ	ミ
躵	シノブ	ネラウ
躺	トウ	フ
躻	ウツケ
躾	シツ	シツケ
軀	カラダ	ク	ムクロ
軁	セムシ	ル	ロウ
軃	タ
軄	ショク	ソク
軅	タカ	ヤガテ
軆	カタチ	カラダ	タイ	テイ
軇	タカ	トウ
軈	ヤガ	ヤガテ
車	クラ	クルマ/グルマ	クロマ	シャ
軋	アツ	キシ/ギシ
軌	キ
軍	イクサ	グン
軏	ガチ	クサビ	ゲツ	ゴチ	ゴツ
軑	タイ	テイ
軒	ケン/ゲン	ノキ
軔	ジ	ジン	ニ	ニン	ハドメ
軛	アク	クビキ	ヤク
軜	タヅナ	ダイ	ドウ	ナイ	ノウ
軟	ナン	ヤワ	ヤワラ
転	ウタ	ウタタ	ウタテ	ウツ	クル	コ	コカ	コロ	テン	マロ
軣	コウ	トドロ
軨	テスリ	リョウ	レイ
軫	シン	ヨコギ
軭	キョウ	ゴウ	トドコオ
軮	オウ	フク
軰	ハイ	バラ	ヤカイ	ヤカラ
軱	オオボネ	ク	コ
軷	ハイ	ハツ	バチ
軸	ジク
軹	アナ	キ	シ	シン	ジクガシラ
軺	ショウ	チョウ	ヨウ
軻	カ
軼	イツ	スギ	テツ
軽	カル/ガル	カロ	キョウ	キン	ケイ
軾	シキ	シキミ	ショク
輀	ジ	ヒツギグルマ
輂	キョク	コク
較	カク	クラ	コウ
輅	クルマ	ロ
輇	ケン	セン	チュン
輈	シュ	シュウ	チュ	チュウ
載	サイ/ザイ	トシ	ノ/ノセ	ノリ
輊	チ
輌	リョウ
輏	カル	ユ	ユウ
輐	カン	マル
輒	スナワチ	チョウ	ワキギ
輓	オソ	バン	ヒ
輔	スケ	タス	タスク	フ	ホ/ポ	ユウ
輕	カル	カロ	ケイ
輖	シュ	シュウ
輗	ギ	クサビ	ゲイ
輘	ヒキツブ	リョウ	ロウ
輙	スナワチ	チョウ	ワキギ
輛	リョウ
輜	コニダ	シ	ニグルマ	ホログルマ
輝	アキ	アキラ	カガヤ	キ	サキ	テ	テル	ヒ	ヒカル
輞	ボウ	モウ	ワ
輟	テツ	ヤ
輠	アブラツボ	カ/ガ	ゲ	ワ
輡	カン	コン
輣	イクサグルマ	ビョウ	ホウ/ボウ
輥	コン	マワル
輦	タゴシ	テグルマ	レン
輧	アツ	カク	ビョウ	ヘイ
輨	オオ	カン
輩	トモガラ	ハイ/バイ/パイ	バラ	ヤカイ	ヤカラ
輪	ナワ	ハナワ	モ	リン	ワ
輬	ネグルマ	リョウ
輭	ゼン	ナン	ネグルマ	ネン
輮	オオワ	ジュウ	ニュ
輯	アツ	シュウ	ヤワ
輳	アツ	ソウ
輴	チュン
輵	アツ	エチ	カチ	カツ
輶	カル	ユ	ユウ
輷	コウ	トドロ
輸	シュ	ユ
輹	トコシバリ	フク
輺	コニダ	シ	ニグルマ	ホログルマ
輻	フク	ヤ
輾	キシ	テン	ネン	メグ
輿	カゴ	コシ	ヨ
轀	ウン	オン
轁	ツツ	トウ	ユブクロ	ユミブクロ
轂	コク	コシキ
轃	シン	セン
轄	カツ	クサビ
轅	エン	ナガエ
轆	コロ	ロク
轇	キョウ	コウ	トオクナガイ
轉	ウタタ	ウツ	コロ	テン	マロ
轌	ソリ
轍	テツ/テッ	ワダチ	ワダチイ
轎	カゴ	キョウ
轏	サン	ゼン
轑	タワ	リョウ	ロウ
轒	フン
轓	ハン	ヘン	ホン
轔	ヒビ	リン
轕	カシマ	カチ	カツ	ケチ
轗	カン	コン
轘	カン	クルマザキ	ケン
轜	ジ	ジシャ	ヒツギグルマ
轝	コシ	ヨ
轞	カン	ゲン	ヒビ
轟	コウ/ゴウ	トドロ	トドロキ	トドロク	ドメキ
轡	クツワ/グツワ	タズナ	タヅナ	ヒ
轢	キシ	ヒ/ヒキ	レキ
轣	レキ
轤	ロ
轥	フミニジ	リン
辛	カノト	カラ/ガラ	カラシ	カロ	シン	ツラ/ヅラ
辜	コ	ツミ
辝	ジ	ヤ
辞	イナ	コトバ	ジ	ヤ
辟	キミ	ヒ	ヒラ	ヘキ	メ
辠	サイ	セ	ソシル	ツミ
辡	ウッタ	ヘン
辣	カラ	ラツ
辤	ジ	ヤ
辥	セチ	セツ	ツミ
辦	ツト	ハン
辧	アラソ	ハナビラ	ヘン/ベン	ワ	ワキマ
辨	アラソ	ハナビラ	ヘン/ベン	ワ	ワキマ
辭	ジ	ヤ
辮	ア	ヘン/ベン
辯	アラソ	ハナビラ	ヘン/ベン	ワ	ワキマ
辰	シン/ジン	タツ/タッ	トキ	ノブ	ノブル
辱	ジョク	ハズカシ
農	ナ	ノ	ノウ	ミ	ミノリ
辵	シンニュウ	シンニョウ	チャク
辶	シンニュウ	シンニョウ	チャク
辷	スベ
辸	オヨ	ショウ	ニョウ	ユ
辺	アタ	アタリ	ナベ	ヘン/ペン	ベ	ホト	ホトリ
辻	ツジ
込	コ/コメ/ゴ	コミ/ゴミ	ゴメ
达	スベ	タイ	タチ	タッス	タツ	テイ	ナメ
辿	タド	タドリ	テン
迀	カン	サエギ	スス	モト
迁	ウツ	セン	ミヤコガエ
迂	ウ	マガ
迄	オヨ	キツ	マデ
迅	ジン
迆	イ	タ	ナ
迊	ソウ	メグ
迋	アザム	オウ	ユ
迍	チュン	トン
迎	ゲイ	ムカ	ムカイ	ムカエ
运	ウン	ハシ
近	オウ	オオ	キン	コノ	コン/ゴン	チカ/ヂカ
迒	アシアト	コウ
迓	ガ	ギョ	ゲ	ゴ	ムカ
返	カエ/カエシ/カエリ	カエシ/ガエシ	ガエ	ガエリ	ヘン/ペン
迕	ゴ	デア
迚	トテ	トテモ
迠	ショウ	チョウ	ユ
迢	チョ	チョウ	ハル
迣	サエギ	セイ	テイ	レイ
迤	イ	タ	ナ
迥	ギョウ	ケイ	ハルカ
迦	カ	ケ
迨	イタ	タイ
迩	ジ	チカ	チカシ	ニ
迪	イタ	イタル	スス	ススミ	ススム	テキ	ミチ	ミチビ	ユウ
迫	サコ/ザコ	セ/ゼ	セコ	セマ	ハク/パク	ハサ/ハザ/バサ	ハサマ/バサマ	ハザマ
迭	テツ
迮	サク	シャク	タ
迯	トウ	ニ	ノガ
述	ジュツ/ジュッ	ノ
迱	イ	タ	ユ
迴	エ	カイ
迵	ズ	トウ	トオ
迶	ウ	ユ	ユウ
迷	マ	マヨ	メイ
迸	ハシ	ヒョウ	ホウ	ホトバシ
迹	アト	シャク/ジャク	セキ	ド
迺	アイ	スナワ	ダイ	ナイ	ナンジ	ノ
迻	イ	ウツ
追	オ/オウ/オッ	オイ	ツイ
迾	サエギ	レイ	レチ	レツ
退	シサ	シリゾ	スサ/ズサ	タイ	ド	ノ	ヒ/ビ
送	オク	ソウ
适	カツ	ガチ	ハヤ
逃	トウ	ニ/ニガ/ニゲ	ノ	ノガ
逄	フサ	ホウ
逅	ア	コウ	マミ
逆	ギャク/ギャッ	ゲキ	サカ
逈	ギョウ	ケイ	ハルカ
逋	ノガ	フ	ホ
逌	ユ	ユウ	ユル
逍	ショウ
逎	シュウ	セマ	ツヨ
透	ス/スカ/スカシ/スキ	トウ	トオ	トオル
逐	オ	チク
逑	キュウ	ツレア
逓	カワ	タガイニ	テイ
途	ト/ド	ミチ
逕	ケイ	コミチ	サシワタシ	タダチニ	ミチ
逖	テキ	トオ
逗	ズ	トウ	トド
逘	ギ	ゲ	シ	スス	マツ
這	ゲン	コノ	シャ	ハ/ハイ/バ	バイ	ムカ
通	カヨ/カヨイ/ガヨ	ツ	ツウ/ヅウ	トオ/トオシ/トオリ/トオル/ドオ	トオシ/ドオシ	トン	ドウシ	ドオリ	ミチ
逛	キョウ	コウ	ハシ
逝	イ	セイ	ユ
逞	タクマ	テイ
速	スミ	ソク/ソッ	ハヤ/バヤ	ワ
造	ズクリ	ゾウ	ツク/ツクリ/ヅク	ヅクリ	ミ	ミヤツコ
逡	シュン	シリゾ
逢	ア/アウ	アイ	オウ	ホウ	ムカ
連	ズレ	ツ/ヅ	ツラ/ヅラ	ツレ	ムラジ	レ	レン
逧	サコ	セコ
逨	イタ	キタル	ツ	ツカ	ライ
逩	カム	ハシ	ホン
逪	サク	ソム	マ	ミダ
逬	シリゾ	ツカウ	ハシ	ヒョウ	ヘイ	ホウ	ホトバシ
逭	カン	ノガ
逮	タイ
逯	タイ/ダイ	リョク	ロク
週	シュウ
進	シン/ジン	スス	ススム	ノブ
逳	アル	イク	メグ	ユ
逴	タク	チャク	トオ
逵	オオジ	キ
逶	イ
逷	ケキ	チャク	テキ	トオ
逸	イツ/イッ	ソ/ソラ	ハグ	ハヤ	ヘン
逹	タチ	タツ	ダ	テ
逼	セマ	ヒキ	ヒツ/ヒッ	ヒョク	フク	ムカバキ
逾	イヨイヨ	コ	ユ
逿	ス	トウ
遁	シュン	トン	ノガ
遂	オオ	スイ	ツイ	ト
遃	アソ	ガン	ゲン	ユ
遄	シバシバ	セン
遅	オク	オソ	ジ	チ
遇	ア	グウ
遉	ウカガ	サスガ	テイ
遊	アス	アソ	ウ	ズサ	ユ	ユウ
運	ウン	ハコ	ハコブ
遌	ガク	デア
遍	アマネ	ヘン/ベン/ペン
過	アヤマ	カ	ス/スギ/スゴ	ヨ/ヨギ
遏	アツ	ト	トド
遐	カ	トオ	ナンゾ
遑	イトマ	カン	コウ	ヒマ
遒	シュウ	セマ	ツヨ
道	サ	ジ	トウ/ドウ	ド	ミチ	ミツ
達	イタル	カツ	サト	サトル	タ	タチ/ダチ	タッ/ダッ	タツ/タッ/ダツ	ダ	テ	テツ	トオル	ミチ
違	イ	タガ	タガイ	チガ
遖	アッパレ
遘	ア	コウ	マミ
遙	ハル	ヨウ
遛	リュウ
遜	シタガ	ソン	ヘリクダ	ユズ
遝	イリマ	トウ
遞	カワ	タガイニ	テイ
遠	エン	オ	オニ	オン	トオ/ドオ	ド
遡	サカノボ	サク/サッ	ソ
遢	トウ
遣	ケン	ツカ/ツカイ/ヅカ	ヅカイ	ヤ	ヤリ	ヨコ
遥	ハル	ハルカ	ヨウ
遦	カン	ケガ	ナレ	ユ
遧	アキ	ショウ
遨	アソ	ゴウ
適	カナ	テキ
遬	カ	コマカイ	スミ	ソク	チヂ	チョク	ツツシ
遭	ア	ソウ
遮	サエギ	シャ
遯	トン	ノガ
遰	サル	セイ	タイ	テイ
遲	オク	オソ	チ
遴	ナヤ	リン
遵	シタガ	ジュン
遶	ジョウ	ニョウ	メグ
遷	ウツ	セン	ミヤコガエ
選	エ	エラ	エリ	セン	ヨ	ヨリ
遹	イチ	イツ	カタヨ	シュツ	ジュチ
遺	イ	ノコ	ヤ	ユイ
遼	ハルカ	リョウ
遽	アワ	アワタダ	キョ	スミヤカ	ニワカ
避	サ	ヒ/ピ	ヨ
邀	ムカ	モト	ヨウ
邁	スス	バイ	マイ	ユ
邂	ア	カイ
邃	オクブカ	スイ
還	カエ/ガエ	カン
邅	ケン	テン	ナヤ
邇	ジ	チカ	ニ
邈	トオ	バク	マク
邉	アタ	ナベ	ヘン	ベ	ホト
邊	アタ	ナベ	ヘン	ベ	ホト
邋	クジク	リョウ	ロウ
邌	オソイ	オモムロ	ジ	チ	ネ	ライ	レイ
邎	ホウ	ユウ
邏	メグ	ラ
邐	ツヅ	リ
邑	オ	オウ	オオ	オオザト	クニ	サト	ムラ	ユウ
邕	ユ	ヨウ
邗	カン
邘	ウ	ク
邙	ボウ	モウ
邛	キョウ	グ
邠	ヒン
邡	ハカ	ホウ
邢	オサカ	ギョウ	ケイ
那	イカン	ダ	トモ	ナ	ナニ	ナンゾ	ヤス
邥	シン
邦	クニ	ホウ/ポウ
邨	ソン	ムラ
邪	ジャ	ヨコシ	ヨコシマ
邯	カン
邰	タイ
邱	オカ	キュウ
邲	ヒ	ヒツ	ビチ
邳	ヒ
邴	ヒョウ	ヘイ
邵	ショウ
邶	ハイ
邸	テイ	ムラ	ヤシキ
邽	ケ	ケイ
邾	シュ	チュ
郁	アヤ	イ	イク	カ	カオル	フミ	ユウ
郃	ア	ギョウ	コウ
郄	キャク	ケキ
郅	イタ	シチ	シツ	チチ	チツ
郇	カン	シュン
郈	ク	コウ
郊	コウ
郌	ケ	ケイ
郎	イラ	オ	オトコ	トウ	モン	リョウ	ロ	ロウ	ロオ
郒	オトコ	リョウ	ロウ
郕	ジョウ	セイ
郗	キ	ケ	チ
郘	リョ	ロ
郙	フ
郛	クルワ	フ/プ
郜	コウ	コク
郝	カク	シャク	セキ
郟	キョウ	コウ
郡	グン	コオリ/ゴオリ
郢	エイ
郤	キャク	ケキ/ゲキ
郥	ハイ
部	トリ	フ/ブ/プ	ベ	ペ	マ
郫	ハイ	ヒ
郭	カク/カッ	クルワ	ヒロ
郯	タン
郰	サン	シュ	シュウ	ショウ
郴	チン
郵	ユウ
郶	ブ	ベ
郷	キョウ	クニ	ゴウ	サト/ザト
都	クニ	ズ	チ	ツ/ヅ	ヅメ	ト/ド	ミヤ	ミヤコ
郾	エン	オン
郿	ビ	ミ
鄀	ジャク	チャク	ニャク
鄂	ガク
鄄	イン	ケン	シン	セン
鄅	ウ
鄆	ウン
鄈	キ
鄍	ベイ	ミョウ	メイ
鄐	キク	チク
鄒	シュ	シュウ	スウ
鄔	ウ	オ	ヨ
鄖	ウン
鄗	カク	コウ
鄘	ユ	ヨウ
鄙	イヤ	ヒ/ピ	ヒナ
鄚	バク	マク
鄜	フ	ロク
鄞	ギン	ゴン
鄠	コ
鄢	エン	オン
鄣	ショウ
鄥	キョウ
鄧	トウ
鄩	シン
鄭	ジョウ	テイ
鄮	ボウ	モ
鄯	セン
鄰	トナ	トナリ	リン
鄱	ハ	ハン	ヒ
鄲	タン
鄴	ギョウ	ゴウ
鄶	カイ	ケ
鄷	ホウ
鄹	シュ	シュウ
鄺	コウ
鄼	アツ	サ	サン
鄽	タナ	テン	ミセ	ヤシキ
酃	リョウ	レイ
酇	アツ	サ	サン
酈	リ	リャク	レキ
酉	トリ/ドリ	ナガ	ミノル	ユウ
酊	テイ	ヨウ
酋	オサ	サケノツカサ	シュウ	ジュ	フルザケ
酌	ク/クミ	シャク
配	クバ	ハイ/バイ/パイ
酎	カモ	チュ	チュウ
酏	アマサケ	イ	キビサケ	ヨネサケ
酒	キ	サ	サカ/ザカ	サケ/ザケ	シ	シュ
酓	エン	カン	コン	タン	ドン	ニガイ
酔	スイ	ヨ/ヨッ	ヨイ
酖	タン	チン	フ
酗	ク
酘	トウ
酙	ク	シン
酚	フン
酛	サケ	サケノモト
酡	アカ	タ
酢	サク	ス/ズ
酣	カン	タケナワ
酤	ク	コ	ヒトヨザケ
酥	ソ
酧	シュ	シュウ	トウ	ムク
酩	メイ	ヨウ
酪	ラク
酬	シュ	シュウ	トウ	ムク
酭	ムク	ユ	ユウ
酲	テイ
酳	イン	シン
酴	サケノモト	ズ	ト
酵	コウ
酷	キビ	コク/コッ	ヒド	ピド	ムゴ
酸	サン	ス/ズ
酹	ソソ	ライ	ラチ	ラツ	ルイ
酺	ウタゲ	ブ	ホ
酻	スイ	ヨイシ
醁	ウマザケ	リョク	ロク
醂	アワ	サワ	ラン	リン
醃	アン	エン	オン
醅	ドブロク	ハイ	フ	フウ
醆	サカズキ	サン	セン
醇	アツイ	アツシ	コイ	シュン/ジュン	モッパラ
醉	スイ	ヨ
醊	チイ	テチ	テツ	マツ
醋	サク	ス
醍	タイ/ダイ	テイ
醎	カラ	カン	シオカライ	シオケ	セイシュ	ダイ
醐	コ/ゴ
醑	ウマザケ	ショ
醒	サ/サマ/サメ/ザ	ザメ	セイ
醓	タン	トン	ヒシオ
醔	オサ	サケノツカサ	シュウ	ジュ	フルザケ
醕	アツシ	コイ	シュン	モッパラ
醗	カモ	ハツ/ハッ
醘	コウ	サカズキ	サカダ
醜	シコ	シュウ	ミニク
醞	ウン	カモ
醡	サ	シャ
醢	カイ	シオカラ	シシビシオ	ヒシオ
醤	ショウ/ジョウ	ヒシオ/ビシオ
醦	サン	シン	ス	スイ	セン
醨	ウスザケ	リ
醪	ニゴリザケ	モロミ	ロウ
醫	イ	クスシ
醬	ショウ	ヒシオ
醭	カビ	ホク
醮	ショウ	マツ
醯	カイ	ケイ
醰	タン	ドン
醱	カモ	ハツ
醲	ジョウ	ドウ	ニュ	ニョウ
醳	エキ	シャク	セキ	ヤク
醴	アマザケ	ライ	レイ
醵	キョ
醶	カン	ゲン	サン	シオカライ	ス	スイ	ラン
醸	カモ	ジョウ
醺	クン	ヨウ
醻	シュ	シュウ	トウ	ムク
醼	エン	サカモリ
醽	リョウ	レイ
醿	ビ
釀	カモ	ジョウ
釁	キン	スキ	チヌ	ヒマ
釂	ショウ	ノミホ
釃	コ	シ	ショ	ソ
釅	ゲン	コイ	サケ	ス
釆	イロドリ	ウネ	サイ	ト	ノゴメ	ハン	ベン
采	イロドリ	サイ	ト
釈	シャ	シャク/シャッ/ジャク	ス	セキ	ト	トク	ユル
釉	ウワグスリ	ユウ
釋	シャク	ス	セキ	トク	ユル
里	サ	サト/ザト	リ
重	エ	オモ	カサ/ガサ	カサネ	サネ	シゲ	シゲル	ジュウ	チョウ
野	ショ	ズケ	ツケ/ヅケ	ヌ	ノ	ヤ
量	カズ	ハカ/ハカリ	リョウ
釐	オサ	サイワ	リ	リン
金	カナ/ガナ	カネ/ガネ	カン	キム	キン	ギン	コ/ゴ	コガネ	コノ	コン/ゴン	ン
釓	イシユミ	キュウ	グ	ヒュウ	ワン
釔	イツ	イトリウ
釖	カタナ	ソリ	トウ
釗	キョウ	ケズ	ショウ	ソウ
釘	クギ	チョウ	テイ
釙	アラガネ	ハク	ポロニウム
釚	イシユミ	キュウ	グ	ヒュウ	ワン
釛	カネ	コガネ	コク
釜	カマ/ガマ	フ/プ
針	シン/ジン	ハ	ハリ/バリ
釞	シュウ	スルド	チュウ
釟	ハチ	ハツ
釡	カマ	フ
釣	チョウ	ツ/ツル/ヅ	ツリ/ヅリ	ツル/ヅル	ヒトシ
釤	オオガマ	サン	セン
釥	カスカ	コマ	ショウ	スルド	ミメヨ	ヨイ	ヨイカネ
釦	ク	コウ	ボタン
釧	ウデワ	クシ	クシロ	セン
釩	ハラ	ハン	ホン
釪	ウ
釬	カン	コテ
釭	カリモ	ク	コウ
釮	ザイ	スルド	セイ	セン
釯	キッサキ	ホコサキ	ボウ
釰	ジツ	ニチ	ニブイ
釱	アシカセ	タイ/ダイ	テイ
釵	カザシ	カンザシ	サ	サイ
釶	シ
釷	ト	トリウム
釹	ジョ
釻	イシユミ	キュウ	グ	ヒュウ	ワン
釼	ケン	ツルギ
釽	サ	ハク	ハナガキ	ヒャク	ヘキ
釿	キン
鈀	イクサグルマ	ハ	ヘ
鈁	サカツボ	ホウ
鈄	ズ	トウ
鈅	ガチ	ゲツ
鈆	エン	ナマリ
鈇	オノ	フ
鈉	キタ	ドウ	ノウ
鈊	カネ	シン
鈌	エチ	エツ	ケ	ケイ	ケチ	ケツ	サ
鈍	ドン	ナマ	ナマク	ニブ	ノロ
鈎	カギ	ク	コウ
鈐	カン	ケン	ゴン	シン	スキ
鈑	ハン/バン
鈒	キュウ	コウ	シュウ	ソウ	テボコ
鈓	ジン	ヌ
鈔	ショウ
鈕	ジュウ	チュウ	ツマミ	ボタン
鈖	フン
鈘	カマ	キ
鈜	オウ	コウ
鈝	イン	キネ
鈞	キン	ヒト	ヒトシ
鈣	カイ	カルシウム
鈤	ゲルマニウム	ジツ
鈥	カ	コウ
鈦	タ	チタニウム
鈨	ハバキ
鈩	イロリ	ロ
鈬	タク
鈮	イトマキノアシ	デイ	ナイ
鈯	トツ	ドチ	ニブイ	ホ
鈰	ケン	シ	セリウム
鈳	ア	カ
鈴	スズ	ズ	リン	レイ
鈵	カタ	ヒョウ	ヘイ
鈶	イ	シ	タイ	タリウム
鈷	コ
鈸	スズ	ハツ	バチ
鈹	カワ
鈺	ギョク	ゴク	タカラ
鈼	カマ	コシキ	サク	セイロウ
鈾	ウラニウム	チュウ	ユウ
鈿	カンザシ	テン/デン
鉀	カリウム	キョウ	コウ	ヨロイ
鉂	カナワ	サ	シ
鉃	シ	スルド	ソク	トイ	ヤジリ	ヤノネ
鉄	クロガネ	ケン	テッ/デッ	テツ/テッ	マガネ
鉅	キョ	ハガネ
鉆	カナバサミ	ケン	チツ	テン
鉇	シ	ホコ
鉈	シャ	ナタ	ホコ
鉉	ケン/ゲン	ツ
鉊	オオカマ	ショウ
鉋	カンナ	ビョウ	ホウ
鉍	ヒ	ヒチ	ヒツ	ビスマス
鉎	サビ	ショウ	セイ	ソウ
鉏	ショ	スキ	ソ
鉐	ジャク	セキ
鉑	ハク	プラチナ
鉗	カン	クビカセ	ケン	ツグ
鉘	カザ	フツ	ブチ
鉙	コガネ	タイ
鉚	ヨイカネ	リュ
鉛	エン	ナマリ
鉜	カザリ	フウ	ブ	ホウ
鉝	リュウ
鉞	エツ	マサカリ
鉠	エイ	ヨウ
鉡	スキ	ハン
鉢	ハチ/バチ/パチ	ハツ
鉤	カギ	ク	コウ	ハリ/バリ
鉥	シュチ	シュツ/ジュツ	ナガイハリ
鉦	カネ/ガネ	ショウ	セイ
鉧	ケラ	ボウ
鉨	イトマキノアシ	デイ	ナイ
鉩	コバコ	ジョウ	タダ	ノウ
鉮	シン
鉯	イ
鉰	シ
鉱	アラガネ	コウ
鉵	スキ	ズ	トウ
鉶	カナエ	ギョウ	ケイ
鉷	グ	コウ
鉸	キョウ	コウ	ハサミ
鉹	イ	コシキ	シ
鉻	カク	キャク	モ	ラク
鉼	オオバン	ヘイ
鉽	カナエノツキモノ	シキ	シュク	ショク
鉾	ホコ/ボコ	ボウ	ム
鉿	オチコムオト	キョウ	コウ
銀	ウン	カナ/ガナ	カネ/ガネ	ギン	シロガネ
銃	ジュウ	ツツ
銅	アカガネ	ドウ
銈	ケイ	テイ
銉	イチ	イツ	ハリ
銊	シュチ	シュツ	ノコギリノオト
銍	カマ	シチ	シツ	チチ	チツ
銎	キョウ	ク
銑	ズク	セン
銒	アツモノナベ	ギョウ	ケイ	ケン	コウ	サケイレ	サケツボ
銓	セン	ハカ
銕	クロガネ	テツ
銖	シュ
銗	クビカセ	グ	コウ
銘	タカ	ミ	メ	メイ
銙	カ	カイ	ケ
銚	チョウ	ナベ	ヨウ
銛	スキ	セン	テン	モリ
銜	カン	クク	クツワ	クワ
銟	サ	シャ
銠	ルテニウム	ロウ
銤	オスミウム	ベイ
銥	イ	イリジウム
銧	コウ	ラジウム
銨	アン
銫	ショク	セシウム
銭	アシ	スキ	セン/ゼン	ゼニ
銯	カスガイ
銲	カン/ガン	コテ
銶	キュウ	グ	ノミ
銷	カワ	ケ	ショウ	ソウ	ト	トロ
銸	カナバサミ	ケヌキ	コバコ	ショウ	チョウ	ノウ	ハサミ
銹	サ	サビ	シュ	シュウ
銺	ソウ
銻	ダイ	テイ
銼	カマ	サ	ソク
銽	カチ	カツ	キ	タ
銿	シュ	ショウ	ツリガネ	ユ	ヨウ
鋀	ズ	トウ	トリウム
鋁	アルミニウム	ヤスリ	リョ	ロ
鋂	クサリ	バイ	ボウ	マイ	ミョウ
鋃	ロウ
鋅	コハイ	シ	シン
鋆	イン	カネ
鋇	アツガネ	ハイ	バリウム
鋈	オク	シロガネ	メッキ	ヨク	ワク
鋋	エン	セン	テボコ
鋌	ジガネ	ジョウ	テイ
鋍	アキコボ	ベリリウム	ホツ	ボチ
鋎	カン	ゲン	ヤイバ
鋏	キョウ	ツルギ	ハサ	ハサミ/バサミ	ヤットコ
鋐	ウツワ	オウ	コウ
鋒	キッサキ	トカリ	ホウ/ポウ	ホコサキ
鋓	スルド	テン
鋕	キザ	シ
鋗	ケン	コバチ	セン
鋘	カ	ゲ	コ	スキ
鋙	ギョ	クイチガ	ゴ
鋜	アシカセ	カナホダシ	サク
鋝	セチ	セツ	レチ	レツ
鋟	キザ	シン	セン	チン
鋠	クロガネ	シン
鋡	イ	カン	ゴン
鋣	ヤ
鋤	クワ	ショ/ジョ	ス	スキ	ソ
鋥	ジョウ	ト	トウ	ミガ
鋧	ケン
鋨	クロガネ	テツ
鋩	キッサキ	ヘサキ	ホコサキ	ボウ
鋪	シキ	シク	フ	ホ/ポ	ミセ
鋬	ハン	ヒモ
鋭	エイ	スルド	トシ
鋮	セイ
鋰	リ	リチウム
鋲	ビョウ
鋳	イ	シュ	シュウ	チュウ
鋸	キョ	コ	ノコ	ノコギリ
鋹	スルド	チョ	チョウ
鋺	エン	カナマリ
鋻	ケン	ツルギノハ
鋼	コウ	ハガネ
鋿	ショウ	ミガ
錀	ウサギアミ	フン	リン
錂	リョウ
錆	クワ	サ	サビ	ショウ	セイ
錈	ガン	ケン	マ
錍	オノ	ハイ	ヒ	ヘイ
錏	ア	エ	シコロ	シロコ
錐	キリ/ギリ	スイ
錑	カンナ	キリ	ネジリ	ノコギリ	モジリ	ライ	レ	レイ
錔	ツツ	トウ
錕	カリモ	コン	ゼン	ネン
錘	オモリ	スイ	ツム
錙	シ
錚	ソウ
錜	カンザシ	ジョウ	ニョウ
錝	ス	ソウ
錞	シュン	ズイ	タイ	トン
錟	セン	タン
錠	ジョウ
錡	カマ	キ	ノコギリ
錢	スキ	セン	ゼニ
錣	シコロ	テイ	テツ
錤	キ	スキ
錥	イク	ナベ
錦	アヤ	カネ	キン	ニシ	ニシキ
錧	カン	クサビ
錨	イカリ	ビョウ	ミョウ
錩	カナグ	ショウ
錪	カマ	テン
錫	シャク	スズ	セキ	タマ
錬	ネ	レン
錮	コ	フサ
錯	サク/サッ	シャク
録	シル	ト	ロク
錳	マンガン	モウ
錴	ロク	ロジウム
錵	カ	ニエ
錶	ヒョウ
錷	アツ	ガドリニウム
錺	カザリ
錻	ブ
鍄	キョウ	リョウ
鍇	カイ	テツ
鍈	エイ	ヨウ
鍉	ウツワ	タイ	テイ
鍋	カ	ナベ
鍍	ト	メッキ
鍐	ス	ソウ
鍑	カマ	フ	フウ	フク
鍒	ジュウ	ジョウ	ナマガネ	ニュ
鍔	ガク	ツバ
鍕	クン
鍖	チン
鍗	カマ	ダイ	テイ
鍘	サツ	ゼチ
鍚	オモガイ	ヨウ
鍛	カ	キタ	タン
鍜	カ
鍞	キョウ	コウ	テイ
鍠	コウ
鍤	ショウ	スキ	ソウ	チョウ
鍥	カマ	キザ	ケイ	ケチ	ケツ
鍧	コウ
鍩	テン	ト
鍪	カマ	ボウ	ム	モ
鍬	クワ/グワ	シュウ	ショウ	スキ
鍭	グ	コウ	ヤ
鍮	チュウ	トウ
鍯	オオノメ	ス	ソウ	ボウ	ム
鍰	エン	カン	ゲン	メカタ
鍱	イタガネ	ショウ	ヨウ
鍳	カガミ	カン	カンガ
鍴	キリ	タン
鍵	カギ	ケン
鍶	シ	シュ	ショウ	セリウム
鍺	タ	マキガネ
鍼	サ	シン	ハリ/バリ
鍽	カネ	ヘン
鍾	アツ	カネ	サカズキ	シュ	ショウ
鍿	シ
鎀	アラガネ	シュ	シュウ
鎁	ヤ
鎂	ビ	マグネシウム
鎈	サ	シャ
鎊	ケズ	ホウ
鎋	カツ	クサビ
鎌	カタ	カネ	カマ/ガマ	ケン	レン
鎍	サク	シャク	ハリガネ
鎏	ウツク	リュウ	ル
鎒	クサギ	クワ	ジュク	ジョク	スキ	ドウ	ヌ
鎔	イガタ	ト	ヨウ	ヨン
鎕	トウ
鎖	クサリ/グサリ	サ	トザ
鎗	ショウ	ソウ	ヤリ
鎘	カク	カドミウム	カナエノツキモノ	リャク	レキ
鎚	タイ	ツイ	ツチ/ヅチ
鎛	カネカザリ	ハク
鎞	カンザシ	ハイ	ヒ	ヘイ
鎡	カナエ	シ
鎣	エイ	ギョウ	ケイ	ミガ	ヨウ
鎤	カネノネ	コウ
鎦	カマ	コシキ	コロ	リュウ	ル
鎧	カイ/ガイ	ヨロ	ヨロイ
鎨	シュン	メバ
鎩	サイ	サツ	セチ	メバ
鎫	バン
鎬	コウ	シノギ	ナベ
鎭	オサエ	シズ	チン
鎮	オサエ	シゲ	シズ	シン/ジン	チカ	チン
鎰	イツ	カギ
鎴	ストロンシウム	ソク
鎵	カ	ガリウム
鎶	カ	コロムビウム
鎹	カスガイ
鎺	ハバキ
鏁	クサリ	サ	トザ
鏃	ソク/ゾク	ヤジリ
鏄	タン	テツノカタマリ
鏅	キタ	シュ	シュウ
鏆	ウガツ	ウデワ	カン
鏇	セン	ロクロ
鏈	クサリ	レン
鏉	エ	サビ	シュ	シュウ	スルド	ソウ	ソク	ホ
鏊	ギョウ	ゴウ	ヤキナベ
鏋	コガネ	バン	マン
鏌	バク	マク
鏍	ラ
鏐	リュウ
鏑	カブラ	カブラヤ	テキ	ヤジリ
鏓	オオノミ	オオノメ	ス	ソウ	ボウ	ム
鏖	オウ	ミナゴロ
鏗	コウ	ツク
鏘	ショウ	ソウ
鏙	サイ	スイ	マ
鏜	トウ
鏝	コテ/ゴテ	マン
鏞	ツリガネ	ユ	ヨウ
鏟	イタガネ	サン	セン
鏡	アキ	カガ	カガミ	カガン	キョウ/ギョウ	ケイ
鏢	コジリ	ヒョウ
鏤	チリバ	ル	ロウ
鏥	サビ	シュウ
鏦	シュ	ショウ	ソウ	ホコ
鏧	ロウ
鏨	サン/ザン	タガネ
鏷	アラガネ	ホク
鏸	エ	エイ	ケイ	スルド	セイ	テイ
鏹	キョウ	コウ	ゼニ
鏺	カマ	ハチ	ハツ
鏻	ツヨ	リョウ	リン	レイ
鏽	サビ	シュウ
鐁	カンナ	シ
鐂	カマ	コシキ	コロ	リュウ	ル
鐃	ドウ	ドラ	ニョウ
鐄	オウ	コウ
鐇	ハン
鐈	キョウ	タカアシノナベ
鐉	セン	テン
鐍	イチ	イツ	オビドメ	ケツ	テチ	テツ
鐎	シュ	シュウ	ショウ	ナベ
鐏	イシヅキ	サン	ソン
鐐	アシカセ	リョウ
鐓	イシヅキ	タイ
鐔	シン	タン	ツバ
鐕	サン
鐖	ガイ	キ	ケ/ゲ	サカバリ
鐗	カン	ケン	ホコ	ムチ
鐘	カネ/ガネ	ショウ
鐙	アブミ	タカツキ	トウ	ヒトモシ
鐚	ア	シコロ	ビタ	ワ
鐟	チタニウム	テイ
鐡	クロガネ	テツ/テッ
鐫	エ	キ	セン	ノミ	ホ
鐮	カマ	ケン	レン
鐯	オオスキ	クワ	シャク	チャク
鐱	ケン	スキ	セン
鐲	ショク	ゾク	タク	フリガネ
鐳	カメ	ライ	ラジウム
鐴	カラスキノミミ	ヒャク	ヘイ	ヘキ	ミガ
鐵	クロガネ	テツ/テッ
鐶	カン	タマキ	ワ
鐸	スズ	タク
鐺	クサリ	コジリ	コテ	ソウ	ト	トウ	ナベ
鐻	カネカケ	キョ	コ
鐽	タツ
鐿	イ	イチルビウム
鑁	バン
鑃	チョウ	ナベ	ヨウ
鑄	イ	シュ	シュウ	チュウ
鑅	コウ
鑈	ゲイ	シ	ジョウ	ナイ	ニ	ニョウ
鑊	カク	カマ	ワク
鑌	ハガネ	ヒン
鑑	アキ	アキラ	カガミ	カン/ガン	カンガ
鑒	カガミ	カン	カンガ
鑓	ヤリ
鑕	カナトコ	シチ	シツ
鑙	カタ	ケイ
鑚	キ	サン
鑛	アラガネ	コウ
鑜	カレイ	ケ	ショウ	ベントウ
鑞	ロウ
鑟	インバコ	トク
鑠	シャク	ト	トロ
鑡	オオバン	サク
鑢	ヤスリ	リョ	ロ
鑣	クツワ	ヒョウ
鑨	ウツワ	ル	ロウ
鑪	イロリ	タタラ	ロ
鑫	キョク	キン	クン	コン
鑭	ラン	ランタニウム
鑮	オオガネ	ハク
鑯	キザ	シン	セン	チン
鑰	カギ	ヤク
鑱	サン	スルド	ゼン
鑲	イガタ	ジョウ	ソウ	ニョウ
鑵	カマ	カン
鑷	ケヌ	ケヌキ	ジョウ	セツ	ニョウ
鑼	ドラ	ラ
鑽	キ/キリ	サン
鑾	スズ	ラン
鑿	ウガ	サク	ノミ
钁	カク	キャク
钃	ショク	スキ	ゾク	チョク	トク
钄	ラン
長	オ	オサ	オサム	オシャ	タ	タカシ	タケ	チョウ	ナ	ナガ	ハ/バ	ヒサ
镸	オサ	チョウ	ナガ	ナガイ
镹	キュウ	ク	ナガ
镾	トリツクロウ	ビ	ミ	ワタ
門	カド	ジョウ	ト/ド	モ	モン	ユキ
閂	カンヌキ	サン	セン
閃	ウカガ	セン	ヒラメ
閄	コク	ワク
閇	シ	タ	ト	ヘイ
閈	カン	サト	ト	フセ
閉	シ/シマ/シメ	タ	ト/トジ	トザ	ヘ	ヘイ/ペイ
閊	ツカ
開	ア	カ	カイ/ガイ	ハル	ヒラ/ヒラク/ビラ	ヒラキ/ビラキ
閌	コウ
閍	ヒョウ	ベン	ホウ	メン
閎	オウ	コウ
閏	ウルウ	ジュン
閑	カン	ガ	ヨリ
間	アイ	アイダ	カン	ケン/ゲン	チカ	ハ	ハサマ	ハザ	ハザマ	ハシ	マ
閔	アワ	ウレ	ビン	ミン
閖	ユ	ユリ
閘	コウ	ヒノクチ
閙	サワガ	トウ/ドウ
閝	キリマド	リョウ	レイ
閞	ハシラノマスガタ	ハン	ヘン	ボン
閟	ト	ヒ
閠	ウルウ	ギョク	ケイ	ジュン
閡	カイ/ガイ	ゲ	コク	シ
関	カカ/カカワ	カラクリ	カン	カンヌキ	セキ/セギ/ゼキ
閣	カク/カッ
閤	クグリド	コウ/ゴウ
閥	バツ
閦	オオ	シュク
閧	コウ	トキ
閨	ケ	ケイ	ネヤ
閩	ビン	ブン	ベン	ミン	モン
閫	コン	シキミ
閬	トウ	リョウ	ロウ
閭	サト	リョ	ロ
閲	エツ/エッ	ケミ
閴	ケキ	シズ	ヒッソリ
閶	ショウ	トウ
閹	アン	エン	オオ
閺	ビン	ベン	ミン
閻	エン
閼	ア	アツ	エン	トド	フサ	ヨ
閽	コン	モンバン
閾	イキ	キョク	クギリ	シキ	シキイ	ヨク
閿	ブン	ミル
闃	ケキ/ゲキ	シズカ	ヒッソリ
闆	ハン	ヘン	ミル
闇	アン	オン	クラ/グラ	ヤミ
闈	イ	キ
闉	イン	エン
闊	カツ/カッ	ヒロ
闋	ケ	ケイ	ケチ	ケツ	ト
闌	タ	タケナワ	テスリ	ラン
闍	ジャ	ト
闐	キ	サカン	テン
闑	キ	ケイ	ゲチ	ゲツ	シキミ
闒	トウ	ムラ	ロウ
闓	カイ	ヒラ
闔	コウ	トビラ
闕	カ	ケツ/ケッ
闖	ウカガ	チン
闘	アラソ	タタカ	ト	トウ
闙	ケイ	ヒラ
闚	ウカガ	キ
關	カカ	カラクリ	カン	カンヌキ	セキ/ゼキ
闝	オボ	ヒョウ
闞	カン	ケン	ノゾ
闟	オチツ	キュウ	コウ	シュウ	ト	トウ
闠	カイ	キ
闡	セン	ミチ
闢	ヒラ	ビャク	ヘキ
闤	エン	カキ	カン	ゲン	ワン
闥	タチ	タツ
闦	ゴン
阜	オカ	コザト	フ	フウ
阝	コザト	コザトヘン
阞	ロク
阡	セン
阢	ギ	ゴチ	ゴツ
阤	クズ	サカ	シ	タ	チ
阥	イン	カゲ
阦	ヒ	ヨウ
阨	アイ	アク	セマ	フサガ	ヤク
阪	サカ/ザカ	ハン/バン
阬	アナ	キョウ	コウ
阮	ゲン
阯	アト	シ
阱	アナ	ジョウ	セイ
防	アタ	ウ	フセ	ホウ/ボウ
阳	ヒ	ヨウ
阷	チョウ	テイ	ノ
阸	アイ	アク	セマ	フサガ	ヤク
阹	キョ
阺	オリ	キョ	コ	テイ
阻	ソ	ハバ
阼	サク	ソ
阽	エン	クズレカ	テン
阿	ア	アズ	アワ	オ	オカ	オモネ	キタ	クマ	ナ	ホトリ
陀	イ	ケワ	ジ	タ/ダ	チ	ナナメ
陁	イ	ケワ	ジ	タ	チ	ナナメ
陂	ツツミ	ハ	ヒ
附	ズキ	ツ/ツケ	ツケタリ	ヅケ	フ/ブ/プ
陋	イヤ	セマ	ロウ
陌	ハク	ハザ	マチ	ミチ
降	オ/オリ/オロ	クダ	コウ/ゴウ	ゴ	フ/ブ	フリ/ブリ	フル
陏	ズイ	ダ
限	カギ	キリ/ギリ	ゲン
陒	キ	ケワ	ヤブ	ヤブレタカキ
陔	カイ	ケ
陖	カイ	シュン	ソバダ
陗	カク	キビ	ケワ	ショウ	セッカチ	セマ	タカ	マッスグデタカイ
陘	キョウ	ケイ	タニ
陛	ヘイ
陜	キョウ	コウ	セマ
陝	セン
陞	ショウ	ノボ
陟	スス	タカ	チョク	トク	ノボ	ノボル
陡	ソバダ	ツ	トウ
院	イン
陣	ジン
除	ジ	ジョ	ノ	ノケ	ノゾ	ノゾキ	ヨ	ヨケ
陥	オチイ	オトシイ	カン
陦	シマ	チョウ	トウ
陪	バイ
陬	シュウ	スウ	スミ
陮	アヤウ	タイ	タカ	テ
陰	イン	カゲ
陲	スイ	ホトリ
陳	ジン	チン	ナラ	ノ	ノブ	ヒ
陴	ハイ	ヒ	ヒメガキ
陵	オカ	ミササギ	リョウ
陶	ス	スエ	トウ/ドウ
陷	オチイ	オトシイ	カン
陸	オカ	クガ	タチ	ミチ	ム	ムツ	リク/リッ	ロク
険	ケワ	ケン
陻	シュ/ジュ	ショウ	ズ	トウ	フサ
陼	シマ	ショ	ズ	ツ	ト
陽	アキ	アキラ	アケ	ハル	ヒ/ビ	ヒロ	ヤン	ヨ	ヨウ
陾	オオ	ジ	ジョウ	ニ	ニョウ
陿	キョウ	コウ	セマ
隁	エン	ツツ
隂	イン	カゲ
隃	コ	シュ	ユ	ヨウ
隄	シ/ジ	タイ	ツツ	テイ
隅	グウ	スミ/ズミ
隆	オ	タカ	タカシ	ユタカ	リュウ
隈	エ	クマ/グマ	スミ	ワイ
隉	アヤ	ゲチ	ゲツ
隊	タイ
隋	スイ/ズイ	タ/ダ
隍	コウ	ホリ
階	カイ/ガイ	キザハシ	シナ	ト	ハシ/ハジ
随	シタガ	ズイ	マニマ
隑	カイ	キ	ゲ	ナガ
隔	カク/カッ	ヘダ
隕	イン	ウン	エン	オチ
隖	ウ	オ	ツツ
隗	カイ	ケワ
隘	アイ	セマ	ヤク
隙	キャク	ケキ/ゲキ	ス	スキ	ヒマ
隚	イシズエ	トウ
際	キワ/ギワ	サイ/ザイ	ワ
障	サワ/サワリ/ザワ	ショウ	ツツ
隝	シマ	チョウ	トウ
隟	キャク	ケキ	ス	スキ	ヒマ
隠	イン	オ	オン	カカ	カク/カクシ/カクレ/ガク	カクレ/ガクレ	ガクシ	コモ	ナバリ	ヨ
隣	チカ	トナ	トナリ/ドナリ	リン
隤	オ	ズイ	タ	タイ
隥	キダ	サカ	トウ
隦	ヒ	ヒメガキ	ヘイ
隧	スイ	ツイ	ミチ
隨	シタガ	ズイ	マニマニ
隩	イク	オウ	クマ
險	ケワ	ケン
隮	サイ	セイ	ノボ
隯	シマ	チョウ	トウ
隰	サワ	シツ	シュウ
隱	イン	オン	カク	ヨ
隲	シツ	チョク	ノボ
隳	キ	クズ
隴	オカ	リョウ	ロウ
隶	タイ	レイヅクリ
隷	シタガ	シモベ	レイ
隸	シタガ	シモベ	レイ
隹	サイ	スイ	トリ	フルトリ
隺	ア	カク	コク
隻	セキ
隼	シュン/ジュン	ハヤ	ハヤブサ
雀	サク/ザク	シャク/ジャク	ジャン	スズメ
雁	カリ/ガリ	カリガネ	ガン
雄	オ	オス	オン	オンドリ	カツ	タケ	タケシ	ツヨシ	ユ	ユウ	ヨウ
雅	ウ	オ	カ/ガ	タダシ	ノリ	マサ	マサシ	ミヤ	ミヤビ	ヨシ
集	アツ/アツマ	アツマリ	シュウ/ジュウ	ズ	タカ/ダカ	ツド/ツドイ
雇	コ	ヤト	ヤトイ
雉	キ	キジ	ジ	チ
雊	ク	コウ
雋	シュン	スグ	セン
雌	シ	メ	メス	メン
雍	フサ	ヤワラ	ユ	ヨウ
雎	ショ
雑	ザツ/ザッ	ゾウ	マ	マジ
雒	ミミズク	ラク
雕	キザ	チョウ	ホ	ワシ
雖	イエド	コレ	スイ
雘	コ	シンシャ	ワク
雙	ソウ	タグイ	ナラブ	フタ	フタツ
雚	カン	コウノトリ
雛	ジュ	ス	スウ	ヒイナ	ヒナ/ビナ	ヒヨコ
雜	サイ	ザツ	ゾウ	マジ
雝	ヤワ	ユ	ヨウ
雞	ケイ	トリ	ニワトリ
雟	エ	キ	ケイ	スイ	ツバメ	メグリ
離	ハナ/バナ	ハナレ/バナレ	リ
難	カタ/ガタ	ナ	ナニ	ナン	ニク	ムズカ	ムツカ	ムヅカ
雨	アマ	アメ	ウ	サメ/ザメ
雩	アマゴイ	ウ	キョ	ク	コ
雪	ススギ	セツ/セッ	ソソ	ブキ	ユキ
雫	シズク	シドケ	ダ
雯	ブン	モン
雰	キリ	フン
雱	ホウ
雲	ウン	キ	クモ/グモ	ズモ	ノメ
零	コボ	ゼロ	レイ
雷	イカズチ	イカツチ	イカヅチ	カミナリ	ライ
雹	ハク	ヒョウ	ヒョク	ボク
雺	キリ	ブ	ボウ	ム
電	イナズマ	デン
需	ジュ
霂	ボク	モク
霃	クモ	ジン	チン
霄	ショウ	ソラ
霅	ギョウ	ショウ	ソウ	トウ	ヤカマ
霆	イカヅチ	テイ
震	シン	フ	フル/ブル
霈	ハイ	ヒサメ
霉	シミ	シメリ	ツユ	バイ	メ
霊	タマ/ダマ	タマシイ	リョウ	レイ
霍	カク	ツル	ニワカ
霎	ショウ	ソウ
霏	ヒ	モヤ
霑	ウルオ	テン
霓	ゲイ	ニジ
霖	ナガアメ	ナガメ	リン
霙	エイ	ミゾレ	ヨウ
霚	キリ	ブ	ボウ	ム
霛	タマ	リョウ	レイ
霜	シモ/ジモ	ソウ
霝	リョウ	レイ
霞	カ	カス	カスミ/ガスミ	ゲ
霡	コサメ	バク	ベキ	ミャク
霢	コサメ	バク	ベキ	ミャク
霣	アメ	イン	ウン	コン
霤	アマダレ	リュウ
霧	キリ/ギリ	ブ	ボウ	ム
霨	イ
霪	イン
霰	アラレ	サン	セン
霱	イチ	イツ	メデタイクモ
露	アラワ	ツユ	ヤ	ユ	ロ	ロウ	ロシア
霳	リュ	リュウ
霸	ハ	ハク	ハタガシラ	ハル
霹	ヒャク	ヘキ
霽	サイ	セイ	ハ
霾	ツチフル	バイ
靁	カミナリ	ライ
靂	レキ
靃	カク	スイ	ハオト
靄	アイ	モヤ
靆	タイ
靈	タマ	リョウ	レイ
靉	アイ	イ
靊	フ	フウ
靎	カク	ツル
靏	カク	ツル
青	アオ/アオザ	オ	サオ	ショウ/ジョウ	セイ
靕	シン	タダ
靖	オサム	キヨシ	シズ	ジョウ	セイ	ノブ	ヤス	ヤスシ
靗	ウカガ	チョウ	テイ
靘	セイ
静	シズ	シズカ	シヅ	シヅカ	ジョウ	セイ
靚	ショウ	セイ
靛	アイ	テン
靜	シズ	シズカ	ジョウ	セイ
非	アラ	ヒ/ピ
靠	コウ	タガ	モタ	ヨ
靡	ナイ	ナビ	ヒ/ビ	ミ	ワ
面	オ	オモ	オモテ	ズラ	ツラ/ヅラ	ベン	ホオツキ	メン	モ
靣	オモ	オモテ	ツラ	ベン	メン
靤	ニキビ	ホウ
靦	テン
靧	カイ	カオヲアラ	ケ
靨	エクボ	ヨウ
革	アラタ	カク	カワ/ガワ
靪	オギナウ	ダイ	チョウ	テイ
靫	ウツオ	ウツボ	サ	サイ	サツ	シナ	ジン	ニン	ユギ
靭	ウツボ	サ	サイ	サツ	シナ	ジン	ニン	ユキ	ユギ
靮	タヅナ	チャク	テキ
靱	ウツオ	ウツボ	サ	サイ	サツ	シナ	ジン	ニン	ユギ
靳	キン	コン	ムナガイ
靴	カ	クツ/グツ
靶	タヅナ	ハ
靷	イン	ジン	チン	ヒキヅナ
靸	クツ	シュウ	ソウ
靹	ケツ
靺	バツ	マツ
靻	オモガイ	ソ	タツ
靼	タチ	タツ	タン	ナメ	ナメシガワ
靽	キズナ	ツナ	ハン	ホダ
靿	オウ	カワグツ	ヨウ
鞀	トウ	フリツヅミ
鞁	ヒ
鞄	カバン	ハク	ビョウ	ホウ
鞅	オウ	ムナガイ	ヨウ
鞆	トモ
鞉	トウ	フリツヅミ
鞋	アイ	カイ	クツ	ワラジ
鞍	アン	クラ/グラ
鞏	カタイ	キョウ
鞐	コハゼ
鞕	カタ	ギョウ	ゴウ
鞖	サイ
鞗	タヅナ	チョウ	トウ
鞘	サヤ/ザヤ	ショウ	ソウ
鞙	ケン
鞚	オモガイ	ク	コウ
鞜	クツ	トウ
鞞	サヤ	バイ	ヒ	ヒョウ	ヘイ
鞟	カク
鞠	キク/キッ	キュウ	マイ	マリ
鞢	ショウ	トウ
鞣	ジュウ	ナメ/ナメシ	ナメシガワ	ニュウ
鞦	シュウ	シリガイ	フラン
鞨	カツ	カワグツ	ガチ	セツ	ゼチ
鞫	キク
鞬	ケン	コン	ユミブクロ
鞭	ヘン/ベン	ムチ	ムチウツ
鞮	カワグツ	タイ	テイ
鞱	ツツ	トウ	ユブクロ	ユミブクロ
鞲	ク	コウ	ユゴテ
鞳	トウ
鞴	ヒ/ビ	フイゴ	フク
鞵	アイ	カイ	クツ	ワラジ
鞶	ハン
鞸	ヒザカケ	ヒチ	ヒツ	ヒョウ	ヘイ
鞹	カク
鞺	トウ
鞼	エ	カイ	キ	クジク	クジケル	ケ	タヅナ	ツヨ	ヌイトリヲシタナメシガワ	ワイ
鞾	カ	クツ
鞿	キ	クツバミ	ケ
韁	キョウ	コウ	タヅナ
韃	タツ/ダツ	ダッ
韄	アク	カク	カタノサゲオ	ギャク	ヤク
韅	ケン
韆	セン
韇	トク	ヤヅツ
韈	シトウズ	バツ	ベツ	マチ	モチ
韉	シタグラ	セン
韊	エビラ	ヤヅツ	ラン	レン
韋	イ	ソム	ナメシガワ
韌	シナヤ	ジン	ニン
韍	ヒ	ヒザカケ	フチ	フツ
韎	アカネゾメノカワ	バイ	バツ	マイ
韐	カワ	キョウ	コウ
韑	イ	ヒカリ
韓	イゲタ	カラ	カン
韔	チョウ	ユミブクロ	リョウ
韗	ウン	カン	クツ	クン	ケン
韘	ショウ	ユガケ
韙	イ	タダ
韛	エビラ	コウ	ハイ	フイゴ	フク
韜	ツツ	トウ	ユブクロ	ユミブクロ
韝	ク	コウ	ユゴテ
韞	ウン	オン	カキイロ
韠	ヒザカケ	ヒチ	ヒツ
韡	イ	サカン
韤	クツシタ	タビ	バツ	ベツ	マチ	モチ
韭	キュウ	ク	ニラ
韮	キュウ	ク	ニラ
韯	セン	ヤマニラ
韱	セン	ヤマニラ
韲	ア	アエモノ	サイ	セイ	ナマス
音	イン	オ	オト	オン	ト	ネ	ノン
韴	ソウ	トギ	トギレゴエ	フツ
韵	イン	ヒビキ
韶	ショウ	ツグ
韷	カマビス	ラク	リャク
韸	フ	フウ	ホウ	ボ	ヤワ
韺	エイ	ヨウ
韻	イン
響	キョウ	ヒビ/ヒビキ
頁	オオガイ	カシラ	ケツ	ペエジ
頂	イタダ	イタダキ	チョウ
頃	キョウ	ケイ	コロ/ゴロ	コロモ	シバラ
項	ウナジ	コウ
順	アヤ	アリ	オキ	オサム	シゲ	シタガウ	ジュン	スナオ	トシ	ナオ	ノブ	ノリ	マサ	ムネ	モト	ユキ	ヨシ	ヨリ
頇	オオ	カン	ガチ	ガツ
須	シュ	ス/ズ	スベカ	スベカラ	スベシ	ゾ	ヒゲ	マツ	モチ	モト	モトム
頊	キョク/ギョク	コク	タダ
頌	カタチ	ショウ	ジュ	タタ	ツグ	ノブ	ホメ	ヨウ
頍	アタマヲア	キ	ケン
頎	カタチガヨイ	キ	キン	ゲ	コン
頏	コウ	ノド
預	アズ/アズケ	アズカ	アヅ	ヨ
頑	カタク	ガン
頒	ハン	ワカ
頓	ツマズ	トツ	トミ	トン/ドン	ニワカ	ヌカズク
頔	ウツク	ジャク	テキ	ヨイ
頖	ハン	ワカツ
頗	カタヨ	スコブ	ハ/パ
領	エリ	ヨウ	ヨシ	リョウ
頙	サク	シャク	シン	タダ
頚	クビ	ケイ
頜	アゴ	カン	コウ	ゴン
頞	アチ	アツ	アン	ハナスジ
頠	ガイ	ギ	シトヤカ
頡	カツ	キツ	ケチ	ケツ
頣	ウカガイミル	シン
頤	アゴ	イ	オトガイ
頥	アゴ	イ	オトガイ
頦	アゴ	カイ
頫	ウツム	バン	フ	マン
頬	キョウ	ホオ	ホホ
頭	アタマ	カシラ/ガシラ	カブリ	カミ/ガミ	コウベ	ジュウ	ズ	チャン	ツブリ	ツムリ	ヅ	ト/ド	トウ/ドウ
頮	カイ	カオヲアラ	ケ
頯	カイ	キュウ	グ	ホオボネ
頰	キョウ	ホオ	ホホ
頲	チョウ	テイ
頳	アカ	チョウ	テイ
頴	エ	エイ	カイ	ノギ	ホサキ
頵	イン	オオ	キン
頷	アゴ	ウナズ	ウナヅ	カン/ガン
頸	クビ	ケイ
頻	シキ	ヒン/ビン/ピン
頼	タノ/ダノ	タヨ	ヨチ	ヨリ	ヨリユキ	ライ
頽	クズ	タイ
頾	クチヒゲ	シ	ヒゲ
顄	オトガイ	カン	ゴン
顆	カ	ツ
顇	シュツ	ジュウ	スイ	ヤツ
顊	イ	オトガイ
顋	アゴ	エラ	サイ
題	ダイ
額	ガク	ヌカ	ヒタイ/ビタイ
顎	アギト	アゴ	ガク/ガッ
顏	カオ	ガン
顑	カン	キイロイ	ケン	コン
顒	オオ	ギョウ	グ
顓	ウヤウヤ	セン
顔	カオ/ガオ	ガン
顕	アキ	アキラ	アキラカ	アラワ	ケン/ゲン
顖	シ	シン	ヒヨメキ
顗	ウヤウヤ	ガイ	ギ	ゲ
願	ガン	ネガ	ネガイ	ラ
顙	ソウ	ヒタイ
顚	イタダ	タオ	テン
顛	イタダキ	タオ	テン
類	タグ	タグイ	ルイ
顢	オオキナカオ	バン	マン
顣	シャク	シュク	セキ	マユヲヒソ
顥	コウ	シロ
顦	ショウ	ヤツ
顧	カエリ	コ	タカ	ミ
顪	カイ	ケ	ホオ
顫	セン	フル
顬	コメカミ	ジュ	ニュ
顯	アキラ	アキラカ	アラワ	ケン/ゲン
顰	シカ	ヒソ	ヒソミ	ヒン/ピン
顱	アタマ	カシラ	ロ
顳	コメ	ショウ
顴	カン	ケン
風	イ	エ	カザ	カゼ	フ/ブ/プ	フウ/プウ
颪	オロシ
颫	フ
颭	セン	ソヨグ
颮	ツムジカゼ	ヒョウ
颯	サツ/サッ	ソウ
颰	ハツ	ハヤテ	バチ	フツ	ブチ	ヘツ	ホチ
颱	タイ
颴	セン	ツムジカゼ
颶	ク/グ
颷	ツムジカゼ	ヒョウ
颸	シ	スズシイカゼ
颺	ア	ヨウ
颻	ヨウ
颿	ハシ	ハン	ヘン	ボン
飂	フク	リク	リュウ	ル	ロク
飃	ツムジカゼ	ヒョウ	ヒルガ
飄	ツムジカゼ	ヒョウ	ヒルガ
飅	フク	リュウ	ル
飆	ツムジカゼ	ヒョウ
飈	ツムジカゼ	ヒョウ
飌	カザ	カゼ	フ	フウ
飛	アス/アズ	ト/トブ	トビ	ヒ/ビ/ピ
飜	ハン	ヒルガエ	ホン
食	ク/クイ/グ	グイ	ショク/ショッ	ジキ	タ/タベ	ハ/バ	メ
飡	クラ	サン	ソン	ノ
飢	ウ	カツ	キ
飣	タクワ	チョウ	テイ
飥	タク	モチ
飦	カユ	カン	ケン	コン	セン	ホシイイ
飧	ソン	バンメシ
飩	トン/ドン
飪	ジン	ニ	ニン
飫	アキ	オ	ヨ	ヨウ
飭	イマシ	タダ	チキ	チョク
飮	イン	オン	ノ
飯	イ	イイ	イリ	エ	ハン/パン	ママ	マンマ	メシ
飲	イン	オン	ノ/ノミ/ノン
飳	コナモチ	シュ	チュ	ツ	トウ
飴	アメ	イ	シ	ヤシナ
飶	カオリ	ヒツ	ビチ	ヘツ	ベチ
飼	カ/ガ	カイ/ガイ	シ
飽	ア	アキ	アク	ホウ
飾	カザ/カザリ	シカ	ショク
餂	ウマイ	テン
餃	キョウ/ギョウ	コウ
餅	ヒョウ	ヘイ/ベイ/ペイ	モチ	モチイ
餇	クイモノ	ズ	ト
餈	シ	モチ
餉	カレイ	ケ/ゲ	ショウ	ベントウ
養	ヤ	ヤシナ	ヨウ	リョウ
餌	エ	エサ	エバ	ジ	ニ	モチ
餐	クラ	サン	ソン	ノ
餑	コウ	ナガ	ホツ	ボチ
餒	イ	ウ	ダイ
餓	ウ	カツ	ガ
餔	ク	フ	ホ	ユウメシ
餕	シュン	セン	タベノコシ
餖	ズ	トウ
餗	カユ	サク	ソク
餘	アマ	ヨ
餚	ギョウ	コウ	ソナ
餛	コン
餜	カ	モチ
餝	カザ	カザリ	コウ	シキ	ショク
餞	セン	ハナムケ
餟	テイ	テチ	テツ	マツ
餠	ヒョウ	ヘイ	モチ	モチイ
餡	アン	カン
餢	ブ	ホウ
餤	タン
餦	アメ	チョウ	モチ
餧	イ	ウ	ダイ
館	カン	タチ	タテ/ダテ	ヤカタ
餫	ウン	オク	コン
餬	カユ	コ
餮	テツ	ムサボ
餱	グ	コウ	ホシイイ
餲	アイ	アチ	アツ	エイ	クサル
餳	アメ	セイ	トウ
餴	フン	ムシメシ	ムス
餵	イ	ウ	ダイ
餹	アメ	トウ
餺	ハク
餻	コウ	コナモチ
餼	オクリモノ	キ	ケ
餽	オク	キ
餾	リュウ
饀	コナモチ	トウ
饁	オウ	オク	コウ	ヨウ
饂	ウドン	ウン
饅	マン
饆	ヒチ	ヒツ	モチ
饇	アク	ウ	オ	オウ	ヨ
饈	シュ	シュウ	スス
饉	ウ	キン
饋	オク	キ
饌	サン	セン	ソナ
饍	カシワ	スス	セン	ソナ
饎	キ	サケサカナ	シ	ム
饐	イ	エイ	エツ	ス	ムセ
饑	ウ	キ
饒	ジョウ	ニョウ	ヌウ	ノ	ユタカ	ヨ
饔	ニ	ユ	ヨウ
饕	トウ	ムサボ
饗	アイ	アエ	ウ	キョウ	モテナ
饘	カユ	セン
饙	フン	ムシメシ	ムス
饛	ボウ	ム	ヤマモリ
饜	アク	エン
饞	サン	ゼン	ムサボ
饟	カレイ	ケ/ゲ	ショウ	ベントウ
饠	モチ	ラ
首	オビト	クビ	コベ	シュ/ジュ	ス
馗	キ
馘	カク	キョク	クビキ	ミミキ
香	カ/ガ	カオ/カオリ/カオル	カグワ	キョウ/ギョウ	コ	コウ	コウヤツ	コオ	ヒャン	ヨシ
馛	コウバ	ニオ	ハツ	バチ	ヘチ	ヘツ
馝	カオリ	ヒツ	ビチ	ヘツ	ベチ
馟	コウバ	ズ	ト
馥	カ	カオ	クク	ヒョク	フク
馦	ケン	コウ
馨	カ	カオ	カオリ	カオル	カグワ	カホル	キョウ	キヨ	ケイ	ヨシ
馬	ウマ	タ	バ	バン	マ	メ	モ
馭	ギョ
馮	タノ	ヒョウ	フ	フウ	ヨ
馰	チャク	テキ
馱	タ	タイ	ノ
馲	タク	チャク	ラク	ラバ	ワク
馳	ジ	チ	ハ/バ
馴	クン	シタガ	シュン/ジュン	ナ/ナラ/ナラシ/ナレ
馵	シュ	ソク/ゾク
馹	ジツ	ニチ	ハヤウマ
馺	オイツク	ソウ
馼	ブン	モン
馽	ショウ	チュウ	ツナ
馿	ウサギウマ	リョ	ロ
駁	ハク/バク/パク	ブチ	マジ	マダラ
駃	ガイ	ケ	ケチ	ケツ	ラバ
駄	タ/ダ
駅	エキ
駆	カ/ガ	カケ	カリ	ク
駈	カ/ガ	ク
駉	キョウ	ケイ	マキ	マキバ
駐	チュウ
駑	ド	ニブ
駒	ク	コマ/ゴマ
駓	シラカゲ	ヒ
駔	ウマ	ショ	ソ	ソウ
駕	カ/ガ	カゴ	シノグ	ノル
駘	タイ
駙	ソエウマ	チカ	フ
駚	オウ	ヨウ
駛	シ	ハ	ハヤ
駜	コ	ヒ	ヒツ	ビチ
駝	セムシ	タ/ダ
駞	セムシ	タ
駟	シ
駢	ナラ	ヘン/ベン
駧	ズ	トウ	ハシ
駪	オオ	シン
駫	キョウ	ケイ	タクマ
駬	シュンメ	ジ	ニ
駭	オドロ	カイ/ガイ
駮	カク	ハク	ブチ	マダラ
駰	イン	ドロアシゲ
駱	カワラゲ	ラク
駲	シュウ	ジュン
駴	アイ	オドロ	カイ
駵	クリゲ	リュウ	ル
駸	シン
駹	ボウ	モウ
駻	カン
駽	ケン
駾	タイ	ハシ
駿	シュン	スグ	ススム	スル	スン	トシ	ハヤオ	ハヤシ
騁	テイ	ハセ
騂	アカウマ	キョウ	ケイ	ショウ	セイ
騃	イ	オロ	ガイ	ギ	シ	タイ
騄	リョク	ロク
騅	アシゲ	スイ
騋	ライ
騌	ソウ	タテガミ
騎	キ
騏	キ
騐	アカシ	ケン	シルシ	タメ
騑	ソエウマ	ヒ
騒	ウレイ	サワ	ソウ/ゾウ	ソク
験	アカシ	ケン/ゲン	シルシ	タメ	タメシ
騖	ハセル	ブ	ム
騙	カタ	ダマ	ヘン
騞	カク	キャク	バク	ミャク
騠	ダイ	テイ
騢	カ	ゲ	ツキゲ
騣	ス	ソウ	タテガミ
騤	キ	ケチ	ケツ	スス
騧	イ	カ	カイ	ゲ
騨	タ/ダ	タン/ダン	テン
騫	ケン
騭	オスウマ	シチ	シツ	チョク
騮	クリゲ	リュウ	ル
騰	ア	アガ	トウ	ノボ
騳	トク	ハシ
騵	ガ	ガン	ゲン
騶	ウマカイ	シュ	シュウ	ス	スウ	チュ
騷	ウレイ	サワ	サワガ	ソウ
騸	セン
騾	ラ
驀	バク
驁	オゴ	ギョウ	ゴウ
驂	サン	ソエウマ
驃	ヒョウ
驄	アシゲ	ス	ソウ
驅	カ	ク
驇	オモイ	チ
驊	アカクリゲ	カ	ゲ
驋	ハシ	ハチ	ハツ
驌	シュク	スク
驍	イサ	イサム	キョウ/ギョウ	スグル	タケシ	ツヨ
驎	マダラウマ	リン
驑	クリゲ	リュウ	ル
驔	クロクリゲ	タン	テン	ドン
驕	オゴ	キョウ
驖	クロクリゲ	テツ	デチ
驗	アカシ	ケン/ゲン	シルシ	タメ	タメシ
驚	オドロ	オドロキ	オドロク	キョウ
驛	エキ
驝	タク	チャク	ラク	ラバ	ワク
驟	シュウ	ニワカ	ハセ
驢	ウサギウマ	リョ	ロ
驤	ア	ショウ/ジョウ
驥	キ
驩	カン	ヨロコ
驪	リ	レイ
驫	ショウ	トドロ
骨	コツ/コッ	ホネ/ボネ/ポネ
骪	アツ	イ	ステオク	マ
骬	ウ
骭	カン	ハギ
骮	コボネ	ヨク
骯	コウ
骰	サイ	トウ
骲	ギョウ	ゴウ	ハク	ビョウ	ホウ	ヤジリ
骴	サイ	シ	ジャ	ホネ
骵	カタチ	カラダ	タイ	テイ
骶	シリ	タイ	テイ
骸	カイ/ガイ	ガラ	ムクロ
骹	キョウ	コウ/ゴウ	ハ
骻	カ	ケ	マタグラ
骼	カク
骾	キョウ	コウ
骿	ヘン
髀	ヒ	ヘイ	モモ
髁	カ	カイ	ケ	モモ
髃	ガイ	グ	ゴウ
髄	ズイ
髆	カイガラボネ	ハク
髈	ホウ	モモ
髎	コシボネ	リュウ	リョウ	ロオ
髏	ロ
髐	カブラヤ	キョウ	コウ
髑	トク/ドク
髒	キタナイ	ソウ
髓	ズイ
體	カタチ	カラダ	タイ	テイ
髕	ヒン
髖	カン	コシボネ	コン
髗	アタマ	カシラ	ロ
高	カ	コ/ゴ	コウ/ゴウ	ジョイ	タ	タカ/ダカ	タカシ	ハカ
髛	アキ	コウ
髜	キョウ	タカ
髞	ソウ	タカシ
髟	カミカンムリ	カミガシラ	ヒュウ	ヒョウ
髠	コン	ソル
髢	カモジ	セキ	テイ
髣	ホウ
髤	ウルシ	キュウ	ク	シ
髥	オオヒゲ	ゼン	ネン
髦	タレガミ	ボウ	モウ
髧	タン	ドン
髩	ヒン
髪	カミ/ガミ	ガタ	ハツ/ハッ/パツ	ヒゲ
髫	ウナ	チョウ
髬	ヒ
髭	クチヒゲ	シ	ヒゲ
髮	カミ	ハツ
髯	ゼン	ヒゲ
髱	タボ	ホウ
髲	カモジ	ヒ
髳	タレガミ	ボウ	ム	モウ
髴	フツ
髵	アゴヒゲ	ジ	ニ
髷	キョク	マゲ	ワゲ
髹	ウルシ	キュウ	ク	シ
髺	カツ	ガチ	タバ
髻	キツ	ケイ	タブサ	ミズラ	モトドリ
髽	ククリガミ	サ	セ
髿	サ	シャ
鬀	カミ	ス	ソ	テイ	マイ
鬁	リ
鬂	ヒン
鬃	ズ	ソウ/ゾウ	タテガミ
鬄	カモジ	シャク	セキ	タイ	チャク	テイ	テキ
鬅	ホウ
鬆	シュ	ショウ	ス	ソウ
鬈	ウルワ	ケン
鬉	ス	ソウ	タテガミ
鬋	セン
鬌	オ	キ	ズイ	タ/ダ	ツイ
鬍	コ
鬎	ラツ
鬐	キ	タテガミ
鬒	オオ	シン
鬖	サン	シン	セン
鬘	カズラ	カツラ/カヅラ	バン	マン
鬙	ソウ	ミダ
鬚	シュ	ス	ヒゲ
鬛	タテガミ	リョウ
鬜	カン	ケン	サン	ゼン	ハ
鬟	カン	ミズラ	ワゲ
鬠	カイ	カツ	ガチ	ケ	タバ	モトユイ
鬢	ヒン/ビン
鬣	タテガミ	リョウ
鬥	タタカイガマエ	トウガマエ
鬦	アラソ	タタカ	トウ
鬧	サワガ	トウ/ドウ
鬨	カチドキ	グ	コウ	トキ/ドキ
鬩	カク	ケキ/ゲキ	セメ
鬪	アラソ	タタカ	トウ
鬫	カン	ケン	ホ
鬭	アラソ	タタカ	トウ
鬮	キュウ	クジ
鬯	カオリグサ	チョウ
鬱	ウツ/ウッ	シゲ	フサ
鬲	カク	カナエ	ヘダ	レキ
鬳	ガン	ケン	コシキ	ゴン
鬴	カマ	フ	リャク	レキ
鬵	オオガマ	シン	セン
鬷	アツ	ス	ソウ
鬹	エ	カマ	キ	ケイ
鬺	ショウ	ニ
鬻	イク	カイ	カユ	シュク	ヒサ
鬼	オニ	キ
鬽	バケモノ	ビ	ミ
魁	イサオ	カイ	カシラ	サキガケ
魂	コン/ゴン	タマ/ダマ	タマシイ/ダマシイ
魃	ハツ/バツ
魄	タク	タマシイ	ハク/パク
魅	ミ
魈	ショウ	スダマ
魋	ズイ	タイ	ツイ
魌	キ	ミニク
魍	ボウ	モウ
魎	コダマ	リョウ
魏	ギ	タカ	タカシ
魑	スダマ	チ
魔	マ
魕	オニ	キ
魖	キョ	コ
魗	シコ	シュウ	ミニク
魘	ウナ	エン	オソ	ヨウ
魚	イ	ウオ	ギョ	サカナ/ザカナ
魛	タチウオ	トウ
魞	エリ
魡	チャク	チョウ	ツル	テキ
魣	カマス	ショ	タナゴ	ヨ
魥	キョウ	コウ	コガメ	コチ	ヒモノ
魦	サ	サメ	シャ	ショウ	チチブ
魨	トン	フグ
魪	カイ	カレイ
魫	サカナノコ	シン
魬	カレイ	ハン
魭	アオウミガメ	ガン	ゲン
魮	ヒ
魯	オロカ	ロ
魳	カマス	シ	ソウ	ハマチ	ブリ
魴	オシキウオ	カガミタイ	カガミダイ	ホウ
魵	エビ	フン
魷	ユウ
魸	ナマズ
魹	トド
魿	ウ	ウロコ	リョウ	リン	レイ
鮀	タ	ナマズ
鮃	ヒョウ	ヒラメ/ビラメ	ヘイ
鮄	サバ	フツ	ブチ
鮅	ヒツ	ビチ	マス
鮆	エツ	ザイ	シ/ジ	セイ
鮇	イワナ	ビ	ミ
鮉	タイ	チョウ
鮊	カスベ	ガンキ	シロウオ	ハ	ハク	ビャク	ベ	ミゴイ
鮋	シュウ	ジュ	ハヤ	ユ	ユウ
鮍	カワハギ	ヒ
鮎	アイ	アユ	デン	ナマズ	ネン
鮏	サケ	ショウ	セイ	ソウ	ナマグサ
鮐	イ	タイ	フグ
鮑	アワビ	ホ	ホウ
鮒	フ/ブ/プ	フナ/ブナ	ホ
鮓	サ	スシ
鮔	キョ
鮖	カジカ
鮗	コノシロ
鮚	キツ	ギチ	ケチ	ケツ	ハマグリ
鮝	ショウ	ヒモノ	フカ	ヨウ
鮞	ジ	ジク	ニ	ニク	ハララゴ
鮟	アン	アンコウ
鮠	カイ/ガイ	ゲ	ハエ	ハヤ
鮦	カツオ	ズ	トウ
鮧	イ	シ	スケソウ	ダイ	テイ	ナマズ
鮨	キ	シ	スシ	ズシ
鮩	アミ	ニゴイ	ヒツ	ビチ	ビョウ	ヘイ	ホウ
鮪	イ	キ	シビ	マグロ	ユウ
鮫	コウ	サメ/ザメ	ミズチ
鮬	カ	カラスミ	ク	ケ	コ	セイゴ	タナゴ	ヒ	ブ	ホ
鮭	カイ	ケイ	サケ/ザケ	シャケ	フグ
鮮	アザ	セン
鮰	カイ
鮱	ボラ
鮲	コチ	マテ	モテ
鮴	コチ	ゴリ	マテ	メバル
鮷	イ	シ	スケソウ	ダイ	テイ	ナマズ
鮸	イシモチ	ニベ	バン	ベン	マン	メン
鮹	ショウ	ソウ	タコ
鮻	サ	サメ	シャ	ショウ	チチブ
鮼	シン
鮾	クサ	ダイ	ナイ
鮿	チョウ	ホシウオ
鯀	クジラ	コン
鯁	キョウ	コウ
鯆	イルカ	フ	ホ
鯇	アメノウオ	カン
鯈	ハエ	ハヤ	ユ	ユウ
鯉	コイ/ゴイ	リ
鯊	サ	サメ	シャ	ハゼ
鯎	ウグイ
鯏	アサリ	ウグイ
鯐	スバシリ
鯑	カズノコ
鯒	コチ
鯔	イナ	シ	トド	ボラ
鯖	サバ	ショウ	セイ
鯗	ショウ	ヒモノ	フカ	ヨウ
鯘	クサ	ダイ	ナイ
鯛	タイ/ダイ	チョウ
鯝	ク	コ	ハラワタ
鯟	ツ	トウ
鯡	ニシン	ハララゴ	ヒ
鯢	ゲイ	サンショウウオ
鯣	エキ	スルメ
鯤	コン
鯥	ムツ	リク	ロク
鯧	ショウ	マナガツオ
鯨	クジラ	ゲイ
鯪	センザンコウ	リョウ
鯫	ス	ソウ	ミゴイ
鯯	コノシロ	セイ
鯰	ナマズ	ネン
鯱	シャチ	シャチホコ
鯲	ドジョウ
鯳	スケソウ	テイ
鯵	アジ	ソウ
鯷	イ	シ	スケソウ	ダイ	テイ	ナマズ	ヒシコ
鯸	グ	コウ	フグ
鯹	サケ	ショウ	セイ	ソウ	ナマグサ
鯺	ショ	フグ
鯽	シャク	ショク	セキ	ソク	タナゴ	フナ
鯿	オシキウオ	ヘン
鰀	アメノウオ	カン
鰂	イカ	ソク
鰄	イ
鰆	サワラ	シュン
鰈	カレイ/ガレイ	チョウ	トウ
鰉	コウ	チョウザメ	ヒガイ
鰊	カド	ニシン	レン
鰋	エン	オン	ナマズ
鰌	シュ	シュウ	ドジョウ
鰍	イナダ	カジカ	シュ	シュウ	ドジョウ
鰏	ヒキ	ヒョク
鰐	ガク	ワニ
鰑	ウナギ	スルメ	ヨウ
鰒	アワビ	フク	フグ
鰓	エラ	サイ	シ
鰔	カレイ	カン	タラ
鰕	エビ	カ
鰖	タ
鰘	ムロア	ムロアジ
鰙	ハヤ	ワカサギ
鰚	ハラカ
鰛	イワシ	オン
鰜	カン	ケン/ゲン	ニシン
鰞	イカ	ウ	オ
鰡	ボラ	リュウ	ル
鰢	ウミエビ	スバシリ	ツクラ	バ	メ
鰣	コノシロ	シ	ハス
鰤	カマス	シ	ソウ	ハマチ	ブリ
鰥	カン	コン	ヤモオ	ヤモメ
鰦	シ	ハヤ
鰧	オコゼ	ジン	チン	トウ
鰨	カレイ	チョウ	トウ
鰩	エイ	ヨウ
鰪	オウ	コウ	マナガツオ
鰭	キ/ギ	ヒレ/ビレ
鰮	イワシ	オン
鰯	イワシ
鰰	ハタハタ
鰱	タナゴ	レン
鰲	オオガメ	ゴウ
鰵	イシモチ	ビン	ミン
鰶	コノシロ	サイ	セイ
鰷	ショウ/ジョウ	チョウ	ハヤ
鰹	カツオ/ガツオ	ケン
鰺	アジ	ソウ
鰻	ウナギ	バン	マン
鰽	コノシロ	シュウ	ジュ
鰾	ウキブクロ	ヒョウ/ピョウ	フエ
鱁	サメ	ジク	チク
鱃	シュ	シュウ	ドジョウ
鱄	セン	タン	レン
鱅	コノシロ	ショウ	ジュ	ユ	ヨウ
鱆	ショウ	タコ
鱇	アンコウ	コウ
鱈	セツ	タラ/ダラ
鱉	スッポン	ヘツ
鱊	イチ	イツ	シュツ	ジュチ
鱎	キョウ	ミゴイ
鱏	イン	エイ	カジキ	シン
鱐	シュ	シュウ	シュク	スク	ホシウオ
鱒	ザン	セン	ソン	マス
鱓	ウツボ	ウミヘビ	ゴマメ	セン	タ
鱔	ウミヘビ	ゴマメ	セン
鱖	カチ	ケ	ケイ	ケツ	サケ
鱗	ウロコ	コケ	コケラ	リン
鱘	カジキ	シン	チョウザメ
鱚	キス
鱛	エソ
鱜	キョウ
鱝	エイ	フン
鱞	カン	コン	ヤ	ヤモオ	ヤモメ
鱟	オク	カブトガニ	グ	コウ	ヨク
鱠	エソ	カイ	ケ	ナマス
鱣	コイ	セン	タン	テン
鱧	ハモ	レイ
鱨	ギギ	ショウ
鱩	ハタハタ
鱪	シイラ
鱫	アイ	ムツ
鱮	ショ	タナゴ	ヨ
鱰	シイラ
鱲	カラスミ	リョウ
鱵	サヨリ	シン
鱶	ショウ	ヒモノ	フカ	ヨウ
鱷	ガク	ワニ
鱸	スズキ	ロ
鱻	アタラシイ	スク	セン
鳥	カ	チョウ	ト/ド	トッ	トリ/ドリ
鳦	アツ	イチ	イツ	エチ	ツバメ
鳧	カモ	ケリ	フ
鳩	アツ	キュウ	ク	ハト/バト	ヤス
鳫	カリ	カリガネ	ガン
鳬	カモ	ケリ	フ
鳰	ニオ
鳲	シ	ヨブコドリ
鳳	オオトリ	フウ	フゲ	ホウ/ポウ
鳴	ナ/ナキ/ナラ	ナキ/ナギ	ナリ	ナル	メイ
鳶	エン	トビ	トンビ
鳷	キ	シ
鳹	カン	キン	ケン	コン	ツイバ
鴂	ケ	ケイ	ケチ	ケツ	サザキ
鴃	ケイ	ケキ/ゲキ	ケツ	モズ
鴆	チン
鴇	トキ	ノガン	ホウ
鴈	カリ	カリガネ	ガン
鴉	ア	カラス/ガラス
鴋	ホウ	ミゾゴイサギ
鴎	オウ	カモメ
鴑	ド	ヌ
鴒	レイ
鴕	タ/ダ
鴗	カワセミ	リュウ
鴘	ヘン	ホン	ワカタカ
鴛	エン	オシ	オシドリ	オン
鴜	シ	ハハドリ
鴝	ク	ハハツチョウ
鴞	キョウ	フクロウ	ヨウ
鴟	シ	トビ
鴣	コ
鴦	オウ
鴨	アヒル	オウ	カモ/ガモ
鴪	イツ
鴫	シギ
鴬	ウグイス	オウ
鴯	ジ	ニ
鴰	カチ	カツ	ケチ	マナヅル
鴲	シ	シメ
鴳	アン	ウズラ	エン
鴴	ギョウ	コウ	スズメ	チドリ
鴺	イ	ダイ	テイ
鴻	オオガリ	オオトリ	コウ/ゴウ	ヒシクイ	ヒロシ
鴼	サギ	ロ
鴽	ウズラ	ジョ	ニョ
鴾	トキ	ボウ
鴿	コウ	ドバト	ハト
鵁	コウ
鵂	キュウ	ク	ミミズク
鵃	チュ	チュウ
鵄	シ	トビ
鵅	カク	キャク	ラク
鵆	チドリ
鵇	トキ
鵈	トビ
鵊	キョウ	コウ	ホトトギス
鵐	ブ	ム
鵑	ケン
鵓	ホツ	ボチ
鵔	シュン
鵙	ケキ/ゲキ	モズ
鵜	ウ	ダイ	テイ
鵝	ガ
鵞	ガ
鵟	キョウ	ゴウ	ヨタカ
鵠	クグイ	コウ	コク	マト
鵡	ブ	ム
鵢	シン
鵣	ライ
鵤	イカル	イカルガ
鵥	カケス
鵩	フク	ミミズク
鵪	アン	ウズラ	オン
鵫	キジ	タク	チョウ	トウ	ヤマドリ
鵬	オオトリ	ホウ
鵯	ヒ	ヒツ	ヒヨドリ
鵰	キザ	チョウ	ホ	ワシ
鵲	カササギ	シャク/ジャク
鵶	ア	カラス
鵷	エン	オン
鵺	コウ	ヌエ	ヤ
鵻	コバト	シュン	スイ
鵼	ク	コウ	ヌエ
鵾	ウン	コン	シャモ	トウマル
鶃	ゲキ
鶄	ゴイサギ	ショウ	セイ
鶆	ライ
鶇	ツ	ツグミ	トウ
鶉	ウズラ	シュン/ジュン
鶊	キョウ	コウ
鶍	イスカ
鶎	キクイ	キクイタダキ
鶏	ケイ/ゲイ	トリ/ドリ	ニワトリ
鶒	オシドリ	シャ	シャク	セキ	チョク
鶓	ビョウ	ミョウ
鶕	アン	フナシウズラ
鶖	ウ	シュ	シュウ
鶗	シ	ダイ	テイ	ホトトギス
鶘	コ/ゴ
鶚	ガク	ミサゴ
鶡	カイ	カク	カツ	ガチ	フン	ヤマドリ
鶤	ウン	コン	シャモ	トウマル
鶩	アヒル	ブ	ボク	ム
鶪	キャク	ケキ	モズ
鶫	ツ	ツグミ	トウ
鶬	ショウ	ソウ	マナヅル
鶮	カク	コク	ツル
鶯	ウグイス	オウ
鶱	ケン	コン	トブ
鶲	ヒタキ/ビタキ
鶴	カ	カク	ズ	タズ	ツ/ヅ	ツル/ヅル
鶵	ジュ	ス	スウ	ヒナ	ヒヨコ
鶸	ジャク	ヒワ
鶹	ミミズク	リュウ	ル
鶺	セキ
鶻	カツ	コツ	ハヤブサ
鶼	カン	ケン	ツイバ
鶿	ウ	シ
鷁	ゲキ
鷂	ハイタカ	ヨウ
鷃	アン	ウズラ	エン
鷄	ケイ	トリ	ニワトリ
鷆	カスイ	シン	テン
鷇	カク	ク	コウ	コク	ヒナ
鷉	テイ
鷊	ギャク	ゲキ
鷏	カスイ	シン	テン
鷓	シャ
鷔	ギュウ	グ	ゴウ	トビウオ
鷕	イ	ナ	ユイ	ヨウ
鷖	エイ	カモメ
鷗	オウ	カモメ
鷙	ゴウ	シ	チツ
鷚	ヒバリ	ボウ	ム	リュウ	ル
鷞	ショウ	ソウ	タカ
鷟	オオトリ	サク
鷠	ギョ	ゴ
鷥	シ	シラサギ
鷦	サ	ショウ
鷧	イ	ウ	エイ
鷩	ヒ	ヘイ	ヘチ	ヘツ
鷫	シュク	スク
鷭	ハン/バン	バ
鷮	オオヤマドリ	キョウ
鷯	リョウ
鷰	エン	ツバクラ	ツバクロ	ツバメ
鷲	シュウ/ジュウ	ジュ	ス	ワ	ワシ	ワセ
鷳	カン	ケン	シラキジ	トビ
鷴	カン	ゲン	シラキジ	トビ
鷸	イツ	シギ
鷹	オウ	タカ/ダカ	ヨウ
鷺	サギ	ロ
鷽	アク	ウソ	カク	ザキ
鷾	イ
鸂	オシドリ	ケイ
鸇	ケン	セン	ハヤブサ
鸊	コバト	ハク	ヒ	ヒャク	ヘキ
鸎	オウ	ヨウ
鸐	ジャク	タク	テキ	ヤマドリ
鸑	ガク
鸒	ヨ
鸕	アタマ	カシラ	ロ
鸖	カク	ツル
鸙	ヒバリ	ヤク
鸚	イン	オウ	ヨウ
鸛	カン	コウノトリ
鸜	ク	ハハツチョウ
鸝	ライ	リ	レイ
鸞	ラン
鹵	シオ	シオチ	タテ	ロ
鹸	ア	カン	ケン	セン
鹹	カラ	カン	シオカライ	シオケ	セイシュ	ダイ
鹺	サ	シ	シオ
鹻	カン	ケン	シオケ
鹼	ア	カン	ケン	セン
鹽	エン	シオ
鹿	カ/ガ	シカ/ジガ	シシ/ジシ	ロク/ロッ
麀	メジカ	ユ	ユウ
麁	アラ	ソ
麂	キ
麃	オオシカ	ビョウ	ホウ
麄	アラ	ソ	ハナ
麅	オオシカ	ビョウ	ホウ
麇	キン	クン	ノロ
麈	オオジカ	シュ	ス
麋	オウシカ	ナレシカ	ビ
麌	オジカ	グ	ゴ
麎	シ	シン
麏	キン	クン
麑	カノコ	ゲイ	コジカ	ベイ
麒	キ
麓	フモト	ロク
麕	キン	クン	ノロ
麖	オオシカ	キョウ	ケイ
麗	ウラ	ウララ	ウルワ	マ	ヨシ	リ	レイ
麘	キョウ	コウ
麛	ベイ	マイ
麝	シャ/ジャ
麞	ショウ	ノロ
麟	リン
麤	アラ	ソ	ハナ
麥	バク	ムギ
麦	バク/バッ	ムギ
麨	ショウ	ムギコガシ
麩	フ/ブ/プ	フスマ
麪	ベン	ムギコ	メン
麬	フ	フスマ
麭	コナモチ	ホウ
麮	キョ	コ	ムギガユ
麯	キク	コウジ
麰	ボウ	ム
麳	コムギ	ムギ	ライ	リ	リキ	リョク
麴	キク	コウジ
麵	ベン	ムギコ	メン
麸	フ	フスマ
麹	キク	コウジ
麺	ベン	ムギコ	メン
麻	ア	アサ	アザ	オ	マ	マア
麼	バ	ビ	マ	ミ	モ
麾	キ	サシズバタ	サシマネ
麿	マ	マロ
黄	ウイ	オウ	キ/ギ	コ	コウ	レイ
黆	コウ	タケシ
黈	キイロ	ツ	トウ
黋	コウ
黌	オウ	コウ
黍	キビ	ショ
黎	クロ	ハジム	リ	レ	レイ
黏	ネバ	ネン
黐	チ	モチ	リ
黒	クロ/グロ	コク/コッ
黔	キン	クロ	ケン
黕	アカ	タン	チン	トン
默	ダ	ボク	モク	モダ
黙	ダマ	ダンマ	ボク	モク/モッ	モダ
黛	タイ	マユズミ
黜	シリゾ	チュツ
黝	アオグロ	ユウ
點	サ	タ	ツ	テン	トボ	トモ	ボチ
黟	イ	エイ	コクタン
黠	カツ	サト	ワルガシコ
黤	アオグロイ	アン	エン	オン
黥	イレズミ	ケイ/ゲイ
黧	クロ	ライ	リ	レイ
黨	トウ	ナカマ	ムラ
黬	アン	エン	カン	クロ	ケン	ナベズミ
黭	アオグロイ	アン	エン	オン
黮	クロ	ジン	タン	チン	ドン
黯	アン	クラ
黰	アン	エン	クロカミ	シン
黱	ジン	タイ/ダイ	チン	マユズミ
黲	ウスアオグロイ	サン
黴	カ	カビ	バイ	ビ	マイ	ミ
黵	セン	タン	ハ
黶	アン	エン	ホクロ
黷	ケガ	トク
黸	クロ	ル	ロ
黹	チ	ヌイトリ	ヌウ	フツ
黻	アヤ	フツ
黼	アヤ	フ	ホ
黽	アオガエル	ツト	ビン	ベン	ボウ	ミン	メン
黿	アオウミガメ	ガン	ゲン
鼂	ウミガメ	ジョウ	チョウ
鼃	カ	カイ	ワイ
鼇	ゴウ
鼈	スッポン	ヘツ/ベツ	ベツ/ベッ
鼉	セン	タ	タン	ワニ
鼎	カナエ	テイ
鼏	ケイ	ベキ	ミャク
鼐	カナエ	ダイ	ドウ	ナイ	ノウ
鼑	カナエ	テイ
鼒	カナエ	シ
鼓	コ	ツツミ	ツヅミ
鼔	ク	コ	ツヅミ
鼕	トウ
鼖	ツツミウツ	フン
鼗	トウ	フリツヅミ
鼙	ツツ	バイ	ヘイ
鼚	チョウ
鼛	オオツヅミ	コウ
鼟	トウ
鼠	ショ	ソ	ネズ	ネズミ
鼡	ショ	ソ	ネズ	ネズミ
鼢	フン	モグラモチ
鼦	チョウ	テン
鼪	イタチ	ショウ	セイ	ソウ
鼫	ジャク	セキ	ムササビ
鼬	イタチ	ユ	ユウ
鼯	ゴ	ムササビ
鼱	ショウ	セイ
鼲	コン
鼴	エン	オン	モグラ
鼷	ケイ	ハツカネズミ
鼹	エン	オン	モグラ
鼺	ムササビ	ルイ
鼻	ハナ/バナ/パナ	ビ
鼼	カギバナ	キュウ	キョウ	ク
鼽	キュウ	グ	ツ
鼾	イビキ	カン
鼿	アオムキバナ	カイ	ゴチ	ゴツ
齁	カギバナ	ク	コ	コウ
齃	アチ	アツ	カチ	カツ	ネイキ
齄	サ	シャ	ハナノワキ
齅	カ	キュウ
齆	オ	オウ	ハナヅマリ	ヨウ
齇	アカバナ	サ	シャ
齊	アタル	サイ	セイ	ソロ	ハヤイ	ヒト	ヒトシ
齋	サイ/ザイ	ツツシ	トキ	モノイミ
齎	サイ	シ	セイ	モタ	モタラ
齏	ア	アエモノ	サイ	セイ	ナマス
齒	シ	ハ	ヨワ	ヨワイ
齓	カケバ	シン	ソン	トン
齔	カケバ	シン	ソン	トン
齕	カ	ケツ	コツ	ゴチ
齖	ガ	ゲ
齗	キン	ハグキ
齘	カイ
齚	カ	サ	サク	ジャ	ジャク
齝	シ	チ	ニゲ	ニレ
齞	ゲン
齟	カム	サ	ショ	ソ
齠	チョウ
齡	トシ	ヨワ	レイ
齢	トシ	ヨワイ	レイ
齣	コマ	シャク	シュツ	セキ
齦	ギン	コン	ハグキ
齧	カ	カジ	ケツ/ゲツ
齨	ウスバ	キュウ	グ
齩	カ	コウ/ゴウ
齪	サク	シュウ	シュク	セク	セマ	ソク
齬	ゴ
齭	イタ	ショ	ソ
齮	カ	キ
齯	ゲイ	ジ	ニ
齰	カ	サ	サク	ジャ	ジャク
齱	サク	シュウ	シュク	セク	セマ	ソク
齲	ウ	ク	ムシバ
齳	グン
齵	グ	ゴウ
齶	アゴ	ガク	ハグキ
齷	アク
齺	サク/ザク	シュ	シュウ
齽	キン	コン	マガリバ
龍	タツ/タッ	リュ	リュウ	リョウ	ロウ
龏	アク	キョウ	ク	ツツシ	トモシビオオイ	ノボ
龐	タカドノ	ホウ	ル	ロウ
龑	エン	ゲン
龒	タ	リュウ	リョウ	ロウ
龔	キョウ	ク	ソナ	ユ	ヨウ
龕	カン/ガン	レイ
龖	オソ	ソウ	トウ
龗	カミ	ヨシ	リョウ	レイ
龜	カメ/ガメ	キ	キュウ	キン	ヒサシ
龝	アキ	シュウ	トキ
龞	スッポン	ヘツ/ベツ
龠	フエ	ヤク
龡	スイ	フキナ	フク
龢	オ	カ	ナゴ	ヤワ	ワ
龣	カク	ロク
龥	ヤク	ユ	ヨ